sim/custom/save_state_enabled	int	включено ли сохранение состояния самолета	1
sim/custom/reset_state	int	сброс состояния самолета	0
sim/custom/save_state	int	принудительное сохранение состояния самолета	0
			
sim/custom/hardware_cockpit	int	Самолет подготовлен для железного кокпита	0

sim/custom/time/frame_time	float	время между кадрами. при прокрутке назад, не принимает отрицательного значения. при FPS меньше 10 - ставит время кадра = 0.1	0.1
sim/custom/anim/cargo_1	float	положение багажной двери 1. 0 - закрыта, 1 - открыта	0
sim/custom/anim/cargo_2	float	положение багажной двери 2. 0 - закрыта, 1 - открыта	0
sim/custom/anim/apu_doors	float	положение створок ВСУ. 0 - закрыты, 1 - открыты.	0
sim/custom/anim/pax_door_1	float	положение передних пасс дверей	0
sim/custom/anim/pax_door_2	float	положение средних пасс дверей	0
sim/custom/anim/pax_door_3	float	положение правых аварийных дверей	0
sim/custom/anim/lg/front_pos	float	положение передней стойки шасси	1
sim/custom/anim/lg/front_defl	float	просадка аммортизатора передней стойки	0
sim/custom/anim/lg/front_turn	float	поворот передней стойки шасси	0
sim/custom/anim/lg/main_pos_left	float	положение левой основной стойки. 0-1 - выпуск, 1+ - просадка аммортизатора	1
sim/custom/anim/lg/main_rot_left	float	поворот левой тележки на земле	0
sim/custom/anim/lg/main_pos_right	float	положение правой основной стойки. 0-1 - выпуск, 1+ - просадка аммортизатора	1
sim/custom/anim/lg/main_rot_right	float	поворот правой тележки на земле	0
sim/custom/anim/light_open_left	float	выпуск левой фары	0
sim/custom/anim/light_open_right	float	выпуск правой фары	0
sim/custom/anim/spd_brk_inn_left	float	положение левого внутреннего спидбрейка	0
sim/custom/anim/spd_brk_inn_right	float	положение правого внутреннего спидбрейка	0
sim/custom/anim/wing_flx_left	float	угол изгиба левого крыла. положительные значения - изгиб вверх	0
sim/custom/anim/wing_flx_right	float	угол изгиба правого крыла. положительные значения - изгиб вверх	0
sim/custom/anim/rudder_anim	float	угол поворота руля направления для анимации. его физичческая модель будет поворачиваться на меньший угол при реверсе.	0
sim/custom/anim/elev_anim_L	float	угол поворота руля высоты	0
sim/custom/anim/elev_anim_R	float	угол поворота руля высоты	0
sim/custom/anim/cockpit_door	float	открывание двери в кабину	0
sim/custom/anim/cockpit_table_1	float	столики на сидениях пилотов	0
sim/custom/anim/cockpit_table_2	float	столики на сидениях пилотов	0
sim/custom/anim/cockpit_vent_1	float	угол поворота вентиляторов	0
sim/custom/anim/cockpit_vent_2	float	угол поворота вентиляторов	0
sim/custom/anim/cockpit_vent_3	float	угол поворота вентиляторов	0
sim/custom/anim/cockpit_window_left	float	открытие форточки	0
sim/custom/anim/cockpit_window_right	float	открытие форточки	0

sim/custom/anim/show_gns	int	в самолете установлена GNS430 вместо KLN	1
sim/custom/anim/RXP	int	в системе установлена RXP	0
sim/custom/anim/show_yokes	int	видны ли штурвалы	1
sim/custom/anim/show_chairs	int	видны ли кресла	1
sim/custom/anim/rise_chair_arm_L	float	поднять ручку кресла	0
sim/custom/anim/rise_chair_arm_R	float	поднять ручку кресла	0
sim/custom/anim/table_up_L	int	поднять столики	0
sim/custom/anim/table_up_R	int	поднять столики	0
			
sim/custom/anim/gpu_present	int	РАП присутствует	0
sim/custom/anim/gpu_work	float	РАП работает. поднятие крышки выхлопа	0

sim/custom/anim/ground_stuff_angle	float	коррекция угла по тангажу для техники	0
		
sim/custom/anim/window_ice_1	float	уровень льда на стеклах	0
sim/custom/anim/window_ice_2	float	уровень льда на стеклах	0
sim/custom/anim/window_ice_3	float	уровень льда на стеклах	0
sim/custom/anim/window_ice_4	float	уровень льда на остальных стеклах	0

sim/custom/anim/gear_blocks	int	установка блоков шасси	0
sim/custom/anim/sensors_caps	int	установка крышек датчиков	0
sim/custom/anim/engine_caps	int	установка крышек двигателей	0

sim/custom/anim/ladder_1	float	трап. 500 - скрыт. +50..0 - подъезжает, 0 - стоит возле замолета, 0..-50 - уезжает	500
sim/custom/anim/ladder_2	float	трап	500
sim/custom/anim/catering	float	кухни	500
sim/custom/anim/fuel_tanker	float	заправщик	500

sim/custom/anim/ladder_1_call	int	трап. 1 подъехать,0 - уехать	0
sim/custom/anim/ladder_2_call	int	трап	0
sim/custom/anim/catering_call	int	кухни	0
sim/custom/anim/fuel_tanker_call	int	заправщик	0

sim/custom/anim/reverse_mid	float	положение общего манипулятора реверса	0
			
sim/custom/buttons/clock_24_left	int	левая кнопка 24-часовых часов. 0 - отжата, 1 - нажата (касается всех кнопок)	0
sim/custom/buttons/clock_24_right	int	правая кнопка 24-часовых часов	0
sim/custom/gauges/clock_24_hours	float	часовая стрелка	0
sim/custom/gauges/clock_24_mins	float	минутная стрелка	0
sim/custom/gauges/clock_24_red	float	красная стрелка	0
			
sim/custom/switchers/spu_1_power	int	переключатель питания на СПУ КВС.  -1 - сеть 2, 0 - выкл, 1 - сеть 1	1
sim/custom/switchers/spu_1_mode	int	переключатель режимов на СПУ КВС. 0 - радио, 1 - СПУ	0
sim/custom/switchers/spu_1_source	int	переключатель источников на СПУ КВС	0
sim/custom/switchers/spu_2_power	int	переключатель питания на СПУ 2П	1
sim/custom/switchers/spu_2_mode	int	переключатель режимов на СПУ 2П	0
sim/custom/switchers/spu_2_source	int	переключатель источников на СПУ 2П	0
sim/custom/switchers/spu_3_power	int	переключатель питания на СПУ ШТ	1
sim/custom/switchers/spu_3_mode	int	переключатель режимов на СПУ ШТ	0
sim/custom/switchers/spu_3_source	int	переключатель источников на СПУ ШТ	0
sim/custom/switchers/spu_4_power	int	переключатель питания на СПУ БИ	1
sim/custom/switchers/spu_4_mode	int	переключатель режимов на СПУ БИ	0
sim/custom/switchers/spu_4_source	int	переключатель источников на СПУ БИ	0
			
sim/custom/lights/mid_left_panel_int_set	int	регулятор встроенного освещения передней панели КВС	3
sim/custom/lights/left_panel_int_set	int	регулятор встроенного освещения левой панели	3
sim/custom/lights/right_panel_int_set	int	регулятор встроенного освещения правой панели	3
sim/custom/lights/mid_right_panel_int_set	int	регулятор встроенного освещения передней панели 2П	3
sim/custom/lights/ovhd_panel_int_set	int	регулятор встроенного освещения верхней панели	3
sim/custom/lights/left_panel_flood_set	float	регулятор яркости заливающего света левой панели	0.3
sim/custom/lights/right_panel_flood_set	float	регулятор яркости заливающего света правой панели	0.3
sim/custom/lights/mid_panel_flood_set	float	регулятор яркости заливающего света центральной панели	0.3
sim/custom/lights/front_panel_flood_set	float	регулятор яркости заливающего света передней панели	0.3
sim/custom/lights/ovhd_front_panel_flood_set	float	регулятор яркости заливающего света передней части оверхеда	0.3
sim/custom/lights/ovhd_back_panel_flood_set	float	регулятор яркости заливающего света заднией части оверхеда	0.3
sim/custom/lights/eng_panel_flood_set	float	регулятор яркости освещения панели БИ	0.3
sim/custom/lights/cabinl_flood_set	int	выключатель освещения кабины	0
sim/custom/lights/azs_panel_flood_set	int	выключатель освещения панели АЗС	0
sim/custom/lights/day_night_set	int	переключатель день - ночь. 0 - день, 1 - ночь. приглушает яркость сигнальных ламп.	0
sim/custom/lights/cargo_light_1_set	int	выключатель освещения грузового отсека	0
sim/custom/lights/cargo_light_2_set	int	выключатель освещения грузового отсека	0
sim/custom/lights/tech_light_set	int	выключатель освещения технического отсека	0
sim/custom/lights/gear_nacelle_light_set	int	выключатель освещения гондол шасси	0
sim/custom/lights/cabin_2d_light	float	яркость 2D подсветки в салоне	0
			
sim/custom/lights/nav_lights_set	int	выключатель нав огней	1
sim/custom/lights/strobe_set	int	выключатель строб огней	1
sim/custom/lights/wing_light_left_set	int	выключатель подсвета крыла	0
sim/custom/lights/wing_light_right_set	int	выключатель подсвета крыла	0
sim/custom/lights/tail_light_set	int	выключатель подсвета хвоста	1
sim/custom/lights/wing_light_left	int	подсветка крыла лев	0
sim/custom/lights/wing_light_right	int	подсветка крыла прав	0
sim/custom/lights/tail_light	int	подсветка хвоста	0
			
sim/custom/lights/landing_ext_set_L	int	выпуск фар лев	0
sim/custom/lights/landing_ext_set_R	int	выпуск фар прав	0
sim/custom/lights/landing_mode_set_L	int	режим фар лев. -1 - рулежный, 0 - выкл, +1 - посадочный	0
sim/custom/lights/landing_mode_set_R	int	режим фар прав	0
sim/custom/lights/light_signal_set	int	сигнал в полете	0
			
sim/custom/controlls/nosewheel_lever	float	рычаг поворота передней ноги	0
sim/custom/controlls/yoke_pitch	float	поворот штурвала ко тангажу	0
sim/custom/controlls/yoke_roll	float	поворот штурвала по крену	0
sim/custom/controlls/pedals	float	поворот педалей	0
sim/custom/controlls/brake_L	float	тормоз педалей лев	0
sim/custom/controlls/brake_R	float	тормоз педалей прав	0
sim/custom/controlls/brake_emerg	float	аварийный тормоз	0
sim/custom/controlls/brake_emerg_L	float	аварийный тормоз лев	0
sim/custom/controlls/brake_emerg_R	float	аварийный тормоз прав	0
sim/custom/controlls/spoilers_lever	float	рычаг интерцепторов	0
sim/custom/controlls/throttle_1	float	РУД 1	0
sim/custom/controlls/throttle_2	float	РУД 2	0
sim/custom/controlls/throttle_3	float	РУД 3	0
sim/custom/controlls/throttle_1_ENG	float	РУД 1 БИ	0
sim/custom/controlls/throttle_2_ENG	float	РУД 2 БИ	0
sim/custom/controlls/throttle_3_ENG	float	РУД 3 БИ	0
sim/custom/controlls/revers_L	float	рычаг реверса лев	0
sim/custom/controlls/revers_R	float	рычаг реверса прав	0
sim/custom/controlls/fuel_cutoff_1	float	рычаг пожарного крана 1	0
sim/custom/controlls/fuel_cutoff_2	float	рычаг пожарного крана 2	0
sim/custom/controlls/fuel_cutoff_3	float	рычаг пожарного крана 3	0
sim/custom/controlls/throttle_lock	float	рычаг фиксации РУД	0
sim/custom/controll/parking_brake	int	ручка фиксации тормоза	0
sim/custom/controll/emerg_gear_ext	int	ручка аварийного выпуска шасси	0
sim/custom/controll/flaps_lever	float	ручка выпуска закрылок. 0-45	0
sim/custom/controll/gear_lever	int	ручка выпуска шасси. -1 - уборка, 0 - нейтр, +1 - выпуск	0
sim/custom/controll/elev_trimm_switcher	int	ручка управления триммером РВ. -1 - пикирование, 0 - нейтр, +1 кабрирование	0
			
			
			
sim/custom/controll/stab_man_cap	int	крышка управления стабилизатором	0
sim/custom/controll/stab_manual	int	ручное уплавение стабилизатором. 0 - нейтр, +1 - кабрирование	0
sim/custom/controll/stab_setting	int	положение центровки для стаба. 0 - З, 1 - С, 2 - П	1
sim/custom/controll/ail_trimm_sw	int	переключатель триммера элеронов	0
sim/custom/controll/rudd_trimm_sw	int	переключатель триммера РН	0
sim/custom/controll/contr_force_cap	int	крышка переключателя загружателя РВ РН	0
sim/custom/controll/contr_force_set	int	переключатель загружателя РВ РН. -1 - полет, 0 авто, +1 - взлет-посадка	0
			
sim/custom/switchers/nosewheel_turn_enable	int	выключатель поворота передней стойки на штурвале	1
sim/custom/switchers/nosewheel_turn_sel	int	переключатель угла поворота передней стойки. 0 - 10, 1 - 63	0
sim/custom/switchers/nosewheel_turn_cap	int	крышка переключателя угла поворота	0
sim/custom/switchers/slat_man	int	ручное управление предкрылками. -1 - уборка, 0 выкл, +1 - выпуск	0
sim/custom/switchers/slat_man_cap	int	крышка ручного урпавления предкрылками	0
sim/custom/switchers/flaps_sel	int	выбор режимов работы закрылков. -1 - выкл, 0 - авт, +1 - ручное	0
sim/custom/switchers/flaps_sel_cap	int	крышка выбора работы закрылков	0
sim/custom/switchers/gears_retr_lock	int	блокировка уборки шасси	0
sim/custom/switchers/gears_retr_lock_cap	int	крышка блокировки уборки шасси	0
sim/custom/switchers/gears_ext_3GS	int	выпуск шасси от 3ГС	0
sim/custom/switchers/gears_ext_3GS_cap	int	крышка выпуска шасси от 3ГС	0
			
sim/custom/gauges/acs1/left_knob_press	int	левая кнопка часов АЧС1 КВС	0
sim/custom/gauges/acs1/right_knob_press	int	правая кнопка часов АЧС1 КВС	0
sim/custom/gauges/acs1/needle_hours	float	часовая стрелка АЧС1 КВС	0
sim/custom/gauges/acs1/needle_mins	float	минутная стрелка АЧС1 КВС	0
sim/custom/gauges/acs1/needle_secs	float	секундная стрелка АЧС1 КВС	0
sim/custom/gauges/acs1/flag_pos	int	красно-белый флажок АЧС1 КВС. -1 - белый, 0 - бело-красный, +1 - красный	0
sim/custom/gauges/acs1/flight_timer_hours	float	часовая стрелка таймера полета	0
sim/custom/gauges/acs1/flight_timer_mins	float	минутная стрелка таймера полета	0
sim/custom/gauges/acs1/stopwatch_mins	float	минутная стрелка секундомера	0
			
sim/custom/gauges/acs2/left_knob_press	int	левая кнопка часов АЧС1 2П	0
sim/custom/gauges/acs2/right_knob_press	int	правая кнопка часов АЧС1 2П	0
sim/custom/gauges/acs2/needle_hours	float	часовая стрелка АЧС1 2П	0
sim/custom/gauges/acs2/needle_mins	float	минутная стрелка АЧС1 2П	0
sim/custom/gauges/acs2/needle_secs	float	секундная стрелка АЧС1 2П	0
sim/custom/gauges/acs2/flag_pos	int	красно-белый флажок АЧС1 2П	0
sim/custom/gauges/acs2/flight_timer_hours	float	часовая стрелка таймера полета	0
sim/custom/gauges/acs2/flight_timer_mins	float	минутная стрелка таймера полета	0
sim/custom/gauges/acs2/stopwatch_mins	float	минутная стрелка секундомера	0
			
sim/custom/gauges/acs3/left_knob_press	int	левая кнопка часов АЧС1 БИ	0
sim/custom/gauges/acs3/right_knob_press	int	правая кнопка часов АЧС1 БИ	0
sim/custom/gauges/acs3/needle_hours	float	часовая стрелка АЧС1 БИ	0
sim/custom/gauges/acs3/needle_mins	float	минутная стрелка АЧС1 БИ	0
sim/custom/gauges/acs3/needle_secs	float	секундная стрелка АЧС1 БИ	0
sim/custom/gauges/acs3/flag_pos	int	красно-белый флажок АЧС1 БИ	0
sim/custom/gauges/acs3/flight_timer_hours	float	часовая стрелка таймера полета	0
sim/custom/gauges/acs3/flight_timer_mins	float	минутная стрелка таймера полета	0
sim/custom/gauges/acs3/stopwatch_mins	float	минутная стрелка секундомера	0
			
sim/custom/gauges/speed/kus_ias_left	float	приборная скорость на КУС730 КВС	0
sim/custom/gauges/speed/kus_tas_left	float	истинная скорость на КУС730 КВС	0
sim/custom/gauges/speed/kus_ias_right	float	приборная скорость на КУС730 2П	0
sim/custom/gauges/speed/kus_tas_right	float	истинная скорость на КУС730 2П	0
sim/custom/gauges/speed/kus_ias_eng	float	приборная скорость на КУС730 БИ	0
sim/custom/gauges/speed/kus_tas_eng	float	истинная скорость на КУС730 БИ	0
sim/custom/gauges/speed/ias_left	float	приборная скорость КВС	0
sim/custom/gauges/speed/ias_yellow_left	float	желтый маркер на индкиторе скорости КВС	0
sim/custom/gauges/speed/ias_right	float	приборная скорость 2П	0
sim/custom/gauges/speed/ias_yellow_right	float	желтый маркер на индкиторе скорости 2П	0
sim/custom/gauges/speed/mach_left	float	скорость маха КВС	0
sim/custom/gauges/speed/mach_right	float	скорость маха 2П	0
sim/custom/gauges/speed/speed_mid_needle	float	стрелка индикатора скорости в центре	0
sim/custom/gauges/speed/speed_mid_flag	int	флажок индикатора скорости в центре 0 - возд, 1 - пут	0
			
sim/custom/gauges/alt/var75	float	выриометр 75 КВС	0
sim/custom/gauges/alt/var30	float	выриометр 30 БИ	0
sim/custom/gauges/alt/radioalt_needle_left	float	стрелка радиовысотомера КВС	0
sim/custom/gauges/alt/radioalt_dh_left	float	стрелка ВПР радиовысотомера КВС	0
sim/custom/gauges/alt/radioalt_flag_left	float	флаг радиовысотомера КВС	0
sim/custom/gauges/alt/radioalt_button_left	int	кнопка тест радиовысотомера КВС	0
sim/custom/gauges/alt/radioalt_needle_right	float	стрелка радиовысотомера 2П	0
sim/custom/gauges/alt/radioalt_dh_right	float	стрелка ВПР радиовысотомера 2П	0
sim/custom/gauges/alt/radioalt_flag_right	float	флаг радиовысотомера 2П	0
sim/custom/gauges/alt/radioalt_button_right	int	кнопка тест радиовысотомера 2П	0
			
sim/custom/gauges/alt/uvid_needle_left	float	стрелка высотомера УВИД КВС	0
sim/custom/gauges/alt/uvid_feet_counter	float	барабанчик счета удиниц футов	0
sim/custom/gauges/alt/uvid_hundreads_counter	float	барабанчик счета сотен футов	0
sim/custom/gauges/alt/uvid_thousands_counter	float	барабанчик счета тысяч футов.	0
sim/custom/gauges/alt/uvid_tens_thousands_counter	float	барабанчик счета десятков тысяч футов.	0
sim/custom/gauges/alt/uvid_pressure_knob	float	ручка установки давления	1013
sim/custom/gauges/alt/uvid_pressure_one	float	единицы давления	3
sim/custom/gauges/alt/uvid_pressure_ten	float	десятки давления	1
sim/custom/gauges/alt/uvid_pressure_hund	float	сотни давления	0
sim/custom/gauges/alt/uvid_pressure_thous	float	тысячи давления	1
			
sim/custom/gauges/alt/vd15_alt_left	float	высота на ВД15 КВС	0
sim/custom/gauges/alt/vd15_tri_needle_left	float	стрелка коррекции на ВД15 КВС	0
sim/custom/gauges/alt/vd15_pressure_left	float	давление на ВД15 КВС	760
			
sim/custom/gauges/alt/vd15_alt_right	float	высота на ВД15 2П	0
sim/custom/gauges/alt/vd15_tri_needle_right	float	стрелка коррекции на ВД15 2П	0
sim/custom/gauges/alt/vd15_pressure_right	float	давление на ВД15 2П	760
			
sim/custom/gauges/alt/vd15_alt_eng	float	высота на ВД15 БИ	0
sim/custom/gauges/alt/vd15_tri_needle_eng	float	стрелка коррекции на ВД15 БИ	0
sim/custom/gauges/alt/vd15_pressure_eng	float	давление на ВД15 БИ	760
			
sim/custom/gauges/alt/vbe_alt_left	float	высота на ВБЭ лев	0
sim/custom/gauges/alt/vbe_press_left	int	давление на ВБЭ лев	1013
sim/custom/gauges/alt/vbe_brt_left	float	яркость на ВБЭ лев	0.7
sim/custom/gauges/alt/vbe_press_knob_left	int	ручка набора давления на ВБЭ лев	0
sim/custom/gauges/alt/vbe_fl_knob_left	int	ручка набора эшелона на ВБЭ лев	0
sim/custom/gauges/alt/vbe_mode_but_left	int	кнопка выбора режимов на ВБЭ лев	0
sim/custom/gauges/alt/vbe_mode_left	int	режим на ВБЭ лев	0
sim/custom/gauges/alt/vbe_std_left	int	включение стандартного давления	0
			
sim/custom/gauges/alt/vbe_alt_right	float	высота на ВБЭ прав	0
sim/custom/gauges/alt/vbe_press_right	int	давление на ВБЭ прав	1013
sim/custom/gauges/alt/vbe_brt_right	float	яркость на ВБЭ прав	0.7
sim/custom/gauges/alt/vbe_press_knob_right	int	ручка набора давления на ВБЭ прав	0
sim/custom/gauges/alt/vbe_fl_knob_right	int	ручка набора эшелона на ВБЭ прав	0
sim/custom/gauges/alt/vbe_mode_but_right	int	кнопка выбора режимов на ВБЭ прав	0
sim/custom/gauges/alt/vbe_mode_right	int	режим на ВБЭ прав	0
sim/custom/gauges/alt/vbe_std_right	int	включение стандартного давления	0

sim/custom/gauges/vsi/vsi_brt_left	float	яркость экрана VSI	0.7
sim/custom/gauges/vsi/vsi_brt_right	float	яркость экрана VSI	0.7
			
sim/custom/gauges/compas/radiocomp_scale_left	float	шкала курса на радиокомпасе КВС	0
sim/custom/gauges/compas/bearing_1_left	float	стрелка направления 1 радиокомпаса КВС	0
sim/custom/gauges/compas/bearing_2_left	float	стрелка направления 2 радиокомпаса КВС	0
sim/custom/gauges/compas/source_1_switch_left	int	переключатель стрелки 1 радиокомпаса КВС. 0 - пусто, 1 - АРК1, 2 - АРК2, 3 - VOR1, 4 - VOR2, 5 - РСБН	1
sim/custom/gauges/compas/source_2_switch_left	int	переключатель стрелки 2 радиокомпаса КВС	2
			
sim/custom/gauges/compas/radiocomp_scale_right	float	шкала курса на радиокомпасе 2П	0
sim/custom/gauges/compas/bearing_1_right	float	стрелка направления 1 радиокомпаса 2П	0
sim/custom/gauges/compas/bearing_2_right	float	стрелка направления 2 радиокомпаса 2П	0
sim/custom/gauges/compas/source_1_switch_right	int	переключатель стрелки 1 радиокомпаса 2П. 0 - пусто, 1 - АРК1, 2 - АРК2, 3 - VOR1, 4 - VOR2, 5 - РСБН	1
sim/custom/gauges/compas/source_2_switch_right	int	переключатель стрелки 2 радиокомпаса 2П	2
			
sim/custom/gauges/compas/big_knob	float	поворот руски ЗК на большом компасе	0
sim/custom/gauges/compas/big_course_needle	float	стрелка "самолетик"	0
sim/custom/gauges/compas/big_true_course_needle	float	стрелка ПУ	0
sim/custom/gauges/compas/big_tri_needle	float	треугольная стрелка	0
			
sim/custom/gauges/compas/pkp_gyro_course_L	float	курс гироскопа ПКП КВС	0
sim/custom/gauges/compas/pkp_obs_L	float	курс полета на ПКП КВС	0
sim/custom/gauges/compas/pkp_helper_course_L	float	устанвока курса желтой стрелкой на ПКП КВС	0
sim/custom/gauges/compas/pkp_slip_angle_L	float	угол сноса на ПКП КВС	0
sim/custom/gauges/compas/pkp_course_plank_L	float	курсовая планка ПКП КВС + отклонение планки вправо	0
sim/custom/gauges/compas/pkp_gs_plank_L	float	глиссадная планка ПКП КВС + отклонение планки вверх	0
sim/custom/gauges/compas/pkp_course_flag_L	int	флаг отказа курсовой планки	0
sim/custom/gauges/compas/pkp_gs_flag_L	int	флаг отказа глиссадной планки	0
sim/custom/gauges/compas/pkp_main_flag_L	int	флаг отказа курса	0
sim/custom/gauges/compas/pkp_obs_flag_L	int	флаг отказа счетчика курса	0
sim/custom/gauges/compas/pkp_obs_one_L	float	счетчик курса. единицы	0
sim/custom/gauges/compas/pkp_obs_ten_L	float	счетчик курса. десятки	0
sim/custom/gauges/compas/pkp_obs_hundr_L	float	счетчик курса. сотни	0
sim/custom/gauges/compas/pkp_obs_knob_L	float	ручка настройки курса	0
sim/custom/gauges/compas/pkp_obs_set_L	float	курс ПНП	0
			
sim/custom/gauges/compas/pkp_gyro_course_R	float	курс гироскопа ПКП 2П	0
sim/custom/gauges/compas/pkp_obs_R	float	курс полета на ПКП 2П	0
sim/custom/gauges/compas/pkp_helper_course_R	float	устанвока курса желтой стрелкой на ПКП 2П	0
sim/custom/gauges/compas/pkp_slip_angle_R	float	угол сноса на ПКП 2П	0
sim/custom/gauges/compas/pkp_course_plank_R	float	курсовая планка ПКП 2П + отклонение планки вправо	0
sim/custom/gauges/compas/pkp_gs_plank_R	float	глиссадная планка ПКП 2П + отклонение планки вверх	0
sim/custom/gauges/compas/pkp_course_flag_R	int	флаг отказа курсовой планки	0
sim/custom/gauges/compas/pkp_gs_flag_R	int	флаг отказа глиссадной планки	0
sim/custom/gauges/compas/pkp_main_flag_R	int	флаг отказа курса	0
sim/custom/gauges/compas/pkp_obs_flag_R	int	флаг отказа счетчика курса	0
sim/custom/gauges/compas/pkp_obs_one_R	float	счетчик курса. единицы	0
sim/custom/gauges/compas/pkp_obs_ten_R	float	счетчик курса. десятки	0
sim/custom/gauges/compas/pkp_obs_hundr_R	float	счетчик курса. сотни	0
sim/custom/gauges/compas/pkp_obs_knob_R	float	ручка настройки курса	0
sim/custom/gauges/compas/pkp_obs_set_R	float	курс ПНП	0
			
sim/custom/gauges/ahz/roll_L	float	крен на АГД КВС + в право	0
sim/custom/gauges/ahz/pitch_L	float	тангаж на АГД КВС + нос вверх	0
sim/custom/gauges/ahz/dir_roll_L	float	директор крена АГД КВС + в право	0
sim/custom/gauges/ahz/dir_pitch_L	float	директор тангажа на АГД КВС + вверх	0
sim/custom/gauges/ahz/course_plank_L	float	курсовая планка АГД КВС + в право	0
sim/custom/gauges/ahz/gs_plank_L	float	глиссадная планка АГД КВС + вверх	0
sim/custom/gauges/ahz/speed_plank_L	float	изменение скорости АГД КВС + вверх	0
sim/custom/gauges/ahz/pitch_corr_L	float	коррекция тангаа на АГД КВС + вправо	0
sim/custom/gauges/ahz/ahz_flag_L	int	флаг отказа АГД КВС	0
sim/custom/gauges/ahz/dir_roll_flag_L	int	флаг отказа директора крена АГД КВС	0
sim/custom/gauges/ahz/dir_pitch_flag_L	int	флаг отказа директора тангажа АГД КВС	0
			
sim/custom/gauges/ahz/roll_R	float	крен на АГД 2П + в право	0
sim/custom/gauges/ahz/pitch_R	float	тангаж на АГД 2П + нос вверх	0
sim/custom/gauges/ahz/dir_roll_R	float	директор крена АГД 2П + в право	0
sim/custom/gauges/ahz/dir_pitch_R	float	директор тангажа на АГД 2П + вверх	0
sim/custom/gauges/ahz/course_plank_R	float	курсовая планка АГД 2П + в право	0
sim/custom/gauges/ahz/gs_plank_R	float	глиссадная планка АГД 2П + вверх	0
sim/custom/gauges/ahz/speed_plank_R	float	изменение скорости АГД 2П + вверх	0
sim/custom/gauges/ahz/pitch_corr_R	float	коррекция тангаа на АГД 2П + вправо	0
sim/custom/gauges/ahz/ahz_flag_R	int	флаг отказа АГД КВС	0
sim/custom/gauges/ahz/dir_roll_flag_R	int	флаг отказа директора крена АГД КВС	0
sim/custom/gauges/ahz/dir_pitch_flag_R	int	флаг отказа директора тангажа АГД КВС	0
			
sim/custom/gauges/ahz/roll_C	float	крен на АГР + в право	0
sim/custom/gauges/ahz/pitch_C	float	тангаж на АГР + нос вверх	0
sim/custom/gauges/ahz/pitch_corr_C	float	коррекция тангажа на АГР + вправо	0
sim/custom/gauges/ahz/ahz_flag_C	int	флаг АГР	0
			
sim/custom/gauges/misc/aoa_ind	float	индикатор угла атаки	0
sim/custom/gauges/misc/aoa_sector	float	сектор индикатора угла атаки	0
sim/custom/gauges/misc/gforce_ind	float	индикатор перегрузки	0
sim/custom/gauges/misc/gforce_max	float	индикатор макс перегрузки	0
sim/custom/gauges/misc/gforce_min	float	индикатор мин перегрузки	0
sim/custom/buttons/misc/gforce_reset	int	кнопка сброса стрелок максимальных перегрузок	0
			
sim/custom/gauges/engine/rpm_low_1	float	обороты турбины низкого давления №1	0
sim/custom/gauges/engine/rpm_low_2	float	обороты турбины низкого давления №2	0
sim/custom/gauges/engine/rpm_low_3	float	обороты турбины низкого давления №3	0
sim/custom/gauges/engine/rpm_high_1	float	обороты турбины высокого давления №1	0
sim/custom/gauges/engine/rpm_high_2	float	обороты турбины высокого давления №2	0
sim/custom/gauges/engine/rpm_high_3	float	обороты турбины высокого давления №3	0
			
sim/custom/gauges/misc/stab_ind	float	индикатор положения стаб	0
sim/custom/gauges/misc/elevator_ind	float	индикатор положения РВ	0
sim/custom/gauges/misc/flap_left_ind	float	индикатор положения левого закрылка	0
sim/custom/gauges/misc/flap_right_ind	float	индикатор положения правого закрылка	0
			
sim/custom/switchers/ZK_select	int	тумблер "ввод ЗК" на передней панели. 0-лев, 1-прав	0
sim/custom/switchers/nav_select	int	тумблер НВУ-СНС 0 - НВУ, 1 - СНС	0
sim/custom/switchers/vbe_select	int	тумблер ВБЭ. 0-лев, 1-прав	0
			
sim/custom/gauges/hydro/pressure_ind_1	float	индикатор давления гидросистемы 1	0
sim/custom/gauges/hydro/pressure_ind_2	float	индикатор давления гидросистемы 2	0
sim/custom/gauges/hydro/pressure_ind_3	float	индикатор давления гидросистемы 3	0
sim/custom/gauges/hydro/pressure_ind_emerg	float	индикатор давления аварийного торможения	0
			
sim/custom/gauges/misc/thermo_outside	float	индикатор температуры за бортом	0
sim/custom/gauges/misc/turn_rate_ind	float	индикатор разворота	0
sim/custom/gauges/misc/slip_rate_ind	float	индикатор скольжения	0
			
sim/custom/gauges/misc/rudder_pos_ind	float	индикатор положения РН	0
sim/custom/gauges/misc/aileron_pos_ind	float	индикатор положения элеронов	0
sim/custom/gauges/misc/elevator_pos_ind	float	индикатор положения РВ	0
			
sim/custom/gauges/misc/fuel_front_ind	float	индикатор топлива на передней панели	0
sim/custom/buttons/misc/fuel_front_zero	int	индикатор топлива на передней панели.кнопка нуля	0
sim/custom/buttons/misc/fuel_front_max	int	индикатор топлива на передней панели.кнопка макс	0
			
sim/custom/gauges/misc/rsbn_azimuth_ind	float	азимут РСБН	0
sim/custom/gauges/misc/rsbn_distance_km	float	дистанция РСБН	0
sim/custom/gauges/misc/rsbn_km_one	float	барабанчик единиц км	0
sim/custom/gauges/misc/rsbn_km_ten	float	барабанчик десятков км	0
sim/custom/gauges/misc/rsbn_km_hun	float	барабанчик сотен км	0
			
sim/custom/gauges/misc/compas_big_needle	float	длинная стрелка на компасе 2П	0
sim/custom/gauges/misc/compas_small_needle	float	короткая стрелка на компасе 2П	0
sim/custom/gauges/misc/compas_knob	float	крутилка на компасе 2П	0

sim/custom/gauges/misc/diss_abs_angle_1	float	барабанчик единиц угла	1
sim/custom/gauges/misc/diss_abs_angle_10	float	барабанчик десятков угла	2
sim/custom/gauges/misc/diss_abs_angle_100	float	барабанчик сотен угла	3
sim/custom/gauges/misc/diss_plus_angle_1	float	барабанчик единиц угла	0
sim/custom/gauges/misc/diss_plus_angle_10	float	барабанчик десятков угла	0
sim/custom/gauges/misc/diss_minus_angle_1	float	барабанчик единиц угла	0
sim/custom/gauges/misc/diss_minus_angle_10	float	барабанчик десятков угла	0
sim/custom/gauges/misc/diss_wind_spd_1	float	барабанчик единиц скорости ветра	0
sim/custom/gauges/misc/diss_wind_spd_10	float	барабанчик десятков скорости ветра	0
sim/custom/gauges/misc/diss_wind_spd_100	float	барабанчик сотен скорости ветра	0
			
sim/custom/switchers/ovhd/var_left	int	оерхед. вар лев	1
sim/custom/switchers/ovhd/var_right	int	оерхед. вар прав	1
sim/custom/switchers/ovhd/uvid_on	int	выключатель УВИД	1
sim/custom/switchers/ovhd/auasp_on	int	оерхед. АУАСП	1
sim/custom/switchers/ovhd/auasp_contr	int	оерхед. АУАСП контроль	0
sim/custom/switchers/ovhd/eup_on	int	выключатель ЭУП	1
sim/custom/switchers/ovhd/agr_on	int	выключатель АГР	1
sim/custom/switchers/ovhd/bkk_contr_cap	int	крышка тумблера контроля БКК	0
sim/custom/switchers/ovhd/bkk_contr	int	контроль БКК. -1 - 2, 0 - выкл, +1 - 1	0
sim/custom/switchers/ovhd/bkk_on_cap	int	крышка выключателя БКК	0
sim/custom/switchers/ovhd/bkk_on	int	выключатель БКК	1
sim/custom/switchers/ovhd/sau_stu_on	int	САУ СТУ выключатель	1
sim/custom/switchers/ovhd/sau_stu_cap	int	крышка выключателя САУ СТУ	0
sim/custom/switchers/ovhd/pkp_left_cap	int	крылка ПКП лев	0
sim/custom/switchers/ovhd/pkp_left_on	int	ПКП лев	1
sim/custom/switchers/ovhd/pkp_right_cap	int	крышка ПКП прав	0
sim/custom/switchers/ovhd/pkp_right_on	int	ПКП прав	1
sim/custom/switchers/ovhd/mgv_contr_cap	int	контроль МГВ крышка	0
sim/custom/switchers/ovhd/mgv_contr	int	контроль МГВ  	1
sim/custom/switchers/ovhd/tks_on_1	int	выключатель ТКС 1	1
sim/custom/switchers/ovhd/tks_on_2	int	выключатель ТКС 2	1
sim/custom/switchers/ovhd/tks_heat	int	обогрев ГА	0
sim/custom/switchers/ovhd/tks_corr_1	int	коррекция БГМК 2 - 1	1
sim/custom/switchers/ovhd/tks_corr_2	int	коррекция БГМК 2 - 2	1
sim/custom/switchers/ovhd/curs_pnp_mode_1	int	режим курс ПНП. 0 - ГМК, 1 - ГПК	1
sim/custom/switchers/ovhd/curs_pnp_mode_2	int	режим курс ПНП. 0 - ГМК, 1 - ГПК	1
sim/custom/buttons/ovhd/svs_contr	int	кнопка контроля СВС	0
sim/custom/switchers/ovhd/svs_on	int	выключатель СВС	1
sim/custom/switchers/ovhd/svs_heat	int	обогрев СВС	1
sim/custom/switchers/ovhd/kln_on	int	выключатель КЛН	1
			
sim/custom/switchers/ovhd/tcas_on	int	выключатель TCAS	1
sim/custom/switchers/ovhd/emerg_light_cap	int	крышка аварийного освещения	0
sim/custom/switchers/ovhd/emerg_light_on	int	аварийное освещение	0
sim/custom/switchers/ovhd/vbe_1_on	int	ВБЭ 1	1
sim/custom/switchers/ovhd/vbe_2_on	int	ВБЭ 2	1
sim/custom/switchers/ovhd/curs_np_on_1	int	курс МП 1	1
sim/custom/switchers/ovhd/curs_np_on_2	int	курс МП 2	1
sim/custom/switchers/ovhd/tra_67_on	int	ТРА 67	1
sim/custom/buttons/ovhd/tks_signal_off	int	снятие блокировки сигнала ТКС	0
sim/custom/switchers/ovhd/rsbn_on	int	РСБН питание	1
sim/custom/switchers/ovhd/rsbn_recon	int	РСБН опознавание	1
sim/custom/switchers/ovhd/rv5_1_on	int	РВ5 1	1
sim/custom/switchers/ovhd/rv5_2_on	int	РВ5 2	1
sim/custom/switchers/ovhd/vhf_1_on	int	УКВ 1	1
sim/custom/switchers/ovhd/vhf_2_on	int	УКВ 2	1
sim/custom/switchers/ovhd/stabil_ga_main	int	стабилизация ГА по крену осн	1
sim/custom/switchers/ovhd/stabil_ga_reserv	int	стабилизация ГА резерв	1
sim/custom/switchers/ovhd/micron_1_on	int	микрон 1	1
sim/custom/switchers/ovhd/micron_2_on	int	микрон 2	1
sim/custom/switchers/ovhd/spu_on	int	СПУ	1
sim/custom/switchers/ovhd/sgs_on	int	СГС	1
sim/custom/switchers/ovhd/sd75_1_on	int	СД75 1	1
sim/custom/switchers/ovhd/sd75_2_on	int	СД75 2	1
sim/custom/switchers/ovhd/mars_on	int	МАРС	1
			
sim/custom/switchers/ovhd/diss_on	int	питание ДИСС	1
sim/custom/switchers/ovhd/diss_mode	int	режим дисс. 0 - море, 1 - суша	1
sim/custom/switchers/ovhd/nvu_calc_set	int	счисление. -1 - контроль ДИСС в полете, 0 - НВУ по СВС, 1 - НВУ по ДИСС	1
			
sim/custom/switchers/ovhd/vent_1	int	вентилятор КВС	0
sim/custom/switchers/ovhd/vent_2	int	вентилятор 2П	0
sim/custom/switchers/ovhd/vent_3	int	вентилятор БИ	0
			
sim/custom/switchers/ovhd/sign_belts	int	транспарант пристегните ремни	1
sim/custom/switchers/ovhd/sign_nosmoke	int	транспарант не курить	1
sim/custom/switchers/ovhd/sign_exit	int	транспарант выход	0
			
sim/custom/switchers/ovhd/window_heat_1	int	обогрев стекол. -1 - слабо, 0 - выкл, 1 - сильно	-1
sim/custom/switchers/ovhd/window_heat_2	int	обогрев стекол. -1 - слабо, 0 - выкл, 1 - сильно	-1
sim/custom/switchers/ovhd/window_heat_3	int	обогрев стекол. -1 - слабо, 0 - выкл, 1 - сильно	-1
sim/custom/switchers/ovhd/pitot_heat_1	int	обогрев ППД лев	1
sim/custom/switchers/ovhd/pitot_heat_2	int	обогрев ППД прав	1
sim/custom/switchers/ovhd/pitot_heat_3	int	обогрев ППД АБСУ	1
			
sim/custom/switchers/ovhd/arm406	int	АРМ 406	1
sim/custom/switchers/ovhd/ushdb_mode_1	int	УШДБ и СПУ 1. 0 - АРК, 1 - VOR	0
sim/custom/switchers/ovhd/ushdb_mode_2	int	обогрев ППД	0
			
sim/custom/switchers/ovhd/egpws_alarm_1	int	сигнализация СРПБЗ общ	1
sim/custom/switchers/ovhd/egpws_alarm_2	int	сигнализация СРПБЗ 	1
sim/custom/switchers/ovhd/egpws_alarm_1_cap	int	сигнализация СРПБЗ общ	0
sim/custom/switchers/ovhd/egpws_alarm_2_cap	int	сигнализация СРПБЗ 	0
sim/custom/switchers/ovhd/egpws_relief	int	рельеф	1
sim/custom/switchers/ovhd/egpws_mode	int	QNH - QFE	0
sim/custom/buttons/ovhd/egpws_control	int	кнопка контроля СРПБЗ	0
sim/custom/buttons/ovhd/egpws_contr_gs	int	контроль СРПБЗ глиссада	0
			
sim/custom/buttons/ovhd/rsbn_control_strobe	int	контроль строба РСБН	0
sim/custom/buttons/ovhd/rsbn_control_azimuth	int	контроль нуля азимут РСБН	0
sim/custom/buttons/ovhd/rsbn_control_distance	int	контроль нуля дальность РСБН	0
sim/custom/buttons/ovhd/rsbn_ch_ten	int	ручка установки десятков канала	0
sim/custom/buttons/ovhd/rsbn_ch_one	int	ручка установки единиц канала	0
			
sim/custom/switchers/ovhd/transponder_mode	int	режим ответчика. 0 откл, 1 готов, 2 рсп, 3 увд, 4 увд-м, 5 ас, 6 а. 	0
sim/custom/buttons/ovhd/transponder_control	int	кнопка контроль	0
sim/custom/buttons/ovhd/transponder_sign	int	кнопка знак	0
sim/custom/buttons/ovhd/transponder_but_1	int	кнопка 1	0
sim/custom/buttons/ovhd/transponder_but_2	int	кнопка 2	0
sim/custom/buttons/ovhd/transponder_but_3	int	кнопка 3	0
sim/custom/buttons/ovhd/transponder_but_4	int	кнопка 4	0
sim/custom/buttons/ovhd/transponder_emerg	int	кнопка авария	0
sim/custom/buttons/ovhd/transponder_emerg_cap	int	крышка кнопки аварии	0
			
sim/custom/switchers/ovhd/tks_mode	int	режим ТКС 0 - МК, 1 - ГПК, 2 - АК	1
sim/custom/switchers/ovhd/tks_mode_left	int	режим левого ГА. 0 - контр, 1 - осн	1
sim/custom/switchers/ovhd/tks_mode_right	int	режим правого ГА	1
sim/custom/switchers/ovhd/tks_lat_mode	int	режим установки широты. 0 - авто, 1 - ручн	1
sim/custom/switchers/ovhd/tks_course_set	int	задатчик курса	0
sim/custom/buttons/ovhd/tks_corrr_button	int	кнопка согласования	0
sim/custom/rotary/ovhd/tks_lat_set	float	ручка установки широты	45
			
sim/custom/switchers/ovhd/ark_1_mode	int	режим АРК 1 0 - выкл, 1 - комп, 2 - ант, 3 - рам	1
sim/custom/switchers/ovhd/ark_1_channel	int	канал АРК 1	1
sim/custom/switchers/ovhd/ark_1_hundr_left	int	сотни частоты 1 - 17	1
sim/custom/switchers/ovhd/ark_1_tens_left	int	десятки частоты 1 - 10 (0)	1
sim/custom/switchers/ovhd/ark_1_ones_left	int	единицы частоты 0 - 9	0
sim/custom/switchers/ovhd/ark_1_hundr_right	int	сотни частоты 1 - 17	1
sim/custom/switchers/ovhd/ark_1_tens_right	int	десятки частоты 1 - 10 (0)	1
sim/custom/switchers/ovhd/ark_1_ones_right	int	единицы частоты 0 - 9	0
sim/custom/buttons/ovhd/ark_1_ramka	int	кнопка рамки	0
			
sim/custom/switchers/ovhd/ark_2_mode	int	режим АРК 2	1
sim/custom/switchers/ovhd/ark_2_channel	int	канал АРК 2	1
sim/custom/switchers/ovhd/ark_2_hundr_left	int	сотни частоты 1 - 17	1
sim/custom/switchers/ovhd/ark_2_tens_left	int	десятки частоты 1 - 10 (0)	1
sim/custom/switchers/ovhd/ark_2_ones_left	int	единицы частоты 0 - 9	0
sim/custom/switchers/ovhd/ark_2_hundr_right	int	сотни частоты 1 - 17	1
sim/custom/switchers/ovhd/ark_2_tens_right	int	десятки частоты 1 - 10 (0)	1
sim/custom/switchers/ovhd/ark_2_ones_right	int	единицы частоты 0 - 9	0
sim/custom/buttons/ovhd/ark_2_ramka	int	кнопка рамки	0
			
sim/custom/switchers/ovhd/sp50_mode	int	режим СП50. 0 - ILS, 1 - Katet, 2 - SP-50	0
sim/custom/switchers/ovhd/sp50_nav_mode	int	режим СП50. посадка - маршрут	0
sim/custom/switchers/ovhd/sp50_night_day	int	режим СП50. ночь - день	1
sim/custom/switchers/ovhd/sp50_dme_rsbn	int	режим СП50. DME - РСБН	0
			
sim/custom/rotary/ovhd/vhf_1_left	int	левая крутилка радио	0
sim/custom/rotary/ovhd/vhf_1_right	int	правая крутилка радио	0
sim/custom/rotary/ovhd/vhf_2_left	int	левая крутилка радио	0
sim/custom/rotary/ovhd/vhf_2_right	int	правая крутилка радио	0
			
sim/custom/switchers/nav_1_mode	int	режим НАВ1. Захват - VOR-DME	1
sim/custom/switchers/nav_1_man_auto	int	режим ручной - автомат	0
sim/custom/switchers/nav_1_mile_km	int	режим мили - км	1
sim/custom/rotary/ovhd/nav_1_left	int	левая крутилка	0
sim/custom/rotary/ovhd/nav_1_right	int	правая крутилка	0
sim/custom/buttons/ovhd/nav_1_but_1	int	кнопка 1	0
sim/custom/buttons/ovhd/nav_1_but_2	int	кнопка 2	0
sim/custom/buttons/ovhd/nav_1_but_3	int	кнопка 3	0
			
sim/custom/switchers/nav_2_mode	int	режим НАВ1. Захват - VOR-DME	1
sim/custom/switchers/nav_2_man_auto	int	режим ручной - автомат	0
sim/custom/switchers/nav_2_mile_km	int	режим мили - км	1
sim/custom/rotary/ovhd/nav_2_left	int	левая крутилка	0
sim/custom/rotary/ovhd/nav_2_right	int	правая крутилка	0
sim/custom/buttons/ovhd/nav_2_but_1	int	кнопка 1	0
sim/custom/buttons/ovhd/nav_2_but_2	int	кнопка 2	0
sim/custom/buttons/ovhd/nav_2_but_3	int	кнопка 3	0
			
sim/custom/gauges/eng/fuel_temp_1	float	температура топлива	20
sim/custom/gauges/eng/fuel_temp_2	float	температура топлива	20
			
sim/custom/gauges/eng/oil_qty_1	float	количество масла	1
sim/custom/gauges/eng/oil_qty_2	float	количество масла	1
sim/custom/gauges/eng/oil_qty_3	float	количество масла	1
			
sim/custom/gauges/eng/km5_scale_1	float	поворот шкалы на КМ5	0
sim/custom/gauges/eng/km5_needle_1	float	стрелка КМ5	0
sim/custom/gauges/eng/km5_knob_1	float	крутилка на КМ5	0
sim/custom/gauges/eng/km5_scale_2	float	поворот шкалы на КМ5	0
sim/custom/gauges/eng/km5_needle_2	float	стрелка КМ5	0
sim/custom/gauges/eng/km5_knob_2	float	крутилка на КМ5	0
			
sim/custom/buttons/lamp_test_front	int	кнопка проверки ламп передней панели	0
sim/custom/buttons/lamp_test_upper_gear	int	кнопка проверки ламп верхней панели шасси	0
sim/custom/buttons/lamp_test_eng_up_1	int	кнопка проверки ламп на панели сливных насадок	0
sim/custom/buttons/lamp_test_eng_up_2	int	кнопка проверки ламп на панели сливных насадок	0
sim/custom/buttons/lamp_test_msrp	int	кнопка проверки ламп МСРП	0
sim/custom/buttons/lamp_test_pa56	int	кнопка проверки ламп на панели гидропитания РА-56	0
sim/custom/buttons/lamp_test_fire_panel	int	кнопка проверки ламп на пожарной панели	0
sim/custom/buttons/lamp_test_apu	int	кнопка проверки ламп на панели ВСУ	0
sim/custom/buttons/lamp_test_engines	int	кнопка проверки ламп на панели приборов двигателей	0
sim/custom/buttons/lamp_test_hydro	int	кнопка проверки ламп на панели гидросистемы	0
sim/custom/buttons/lamp_test_srd	int	кнопка проверки ламп на панели наддува	0
sim/custom/buttons/lamp_test_doors	int	кнопка проверки ламп на панели индикации дверей и люков	0
			
sim/custom/switchers/eng/wing_light	int	габаритные наземные огни на крыле	1
sim/custom/switchers/eng/door_heat	int	обогрев дверей	0
sim/custom/switchers/eng/gear_fan	int	вентиляция шасси	0
sim/custom/switchers/eng/galley_heat	int	обогрев слива кухни	0
sim/custom/switchers/eng/lavatory_heat	int	обогрев слива туалетов	0
sim/custom/switchers/eng/water_meter	int	уровень воды в баке	0
sim/custom/switchers/eng/water_compressor_1	int	обогрев слива кухни	0
sim/custom/switchers/eng/water_compressor_2	int	обогрев слива кухни	0
sim/custom/gauges/eng/water_pressure	float	давление воды	0
sim/custom/buttons/eng/tail_temp_signal_control_1	int	контроль сигнала температуры хвостового отсека	0
sim/custom/buttons/eng/tail_temp_signal_control_2	int	контроль сигнала температуры хвостового отсека	0
sim/custom/switchers/eng/tail_temp_signal	int	сигнал температуры хвостового отсека	0
sim/custom/switchers/eng/tail_temp_heat	int	обогрев АРД	0
			
sim/custom/switchers/eng/msrp_date_ten	int	МРСП дата число десятки	0
sim/custom/switchers/eng/msrp_date_one	int	МРСП дата число единицы	0
sim/custom/switchers/eng/msrp_month_ten	int	МРСП дата месяц десятки	0
sim/custom/switchers/eng/msrp_month_one	int	МРСП дата месяц единицы	0
sim/custom/switchers/eng/msrp_year_ten	int	МРСП дата год десятки	0
sim/custom/switchers/eng/msrp_year_one	int	МРСП дата год единицы	0
sim/custom/switchers/eng/msrp_route_hun	int	МРСП рейс. сотни	0
sim/custom/switchers/eng/msrp_route_ten	int	МРСП рейс. десятки	0
sim/custom/switchers/eng/msrp_route_one	int	МРСП рейс. единицы	0
sim/custom/switchers/eng/msrp_mlp_1	int	МРСП млп осн	1
sim/custom/switchers/eng/msrp_mlp_2	int	МРСП млп доп	1
sim/custom/switchers/eng/msrp_night_day	int	МРСП ночь - день	1
sim/custom/switchers/eng/msrp_main_switch	int	МРСП главный выключатель	1
			
sim/custom/switchers/eng/hydro_trimm_rud_1	int	триммирование РВ 1	1
sim/custom/switchers/eng/hydro_trimm_rud_2	int	триммирование РВ 2	1
sim/custom/switchers/eng/hydro_trimm_rud_1_cap	int	триммирование РВ 1	0
sim/custom/switchers/eng/hydro_trimm_rud_2_cap	int	триммирование РВ 2	0
			
sim/custom/switchers/eng/emerg_gen_on_1	int	аварийное включение генераторов	0
sim/custom/switchers/eng/emerg_gen_on_2	int	аварийное включение генераторов	0
sim/custom/switchers/eng/emerg_gen_on_3	int	аварийное включение генераторов	0
sim/custom/switchers/eng/emerg_gen_on_1_cap	int	аварийное включение генераторов	0
sim/custom/switchers/eng/emerg_gen_on_2_cap	int	аварийное включение генераторов	0
sim/custom/switchers/eng/emerg_gen_on_3_cap	int	аварийное включение генераторов	0
			
sim/custom/switchers/eng/hydro_ra56_rud_1	int	гидропитание РА56 курс	1
sim/custom/switchers/eng/hydro_ra56_rud_2	int	гидропитание РА56 курс	1
sim/custom/switchers/eng/hydro_ra56_rud_3	int	гидропитание РА56 курс	1
sim/custom/switchers/eng/hydro_ra56_ail_1	int	гидропитание РА56 крен	1
sim/custom/switchers/eng/hydro_ra56_ail_2	int	гидропитание РА56 крен	1
sim/custom/switchers/eng/hydro_ra56_ail_3	int	гидропитание РА56 крен	1
sim/custom/switchers/eng/hydro_ra56_elev_1	int	гидропитание РА56 тангаж	1
sim/custom/switchers/eng/hydro_ra56_elev_2	int	гидропитание РА56 тангаж	1
sim/custom/switchers/eng/hydro_ra56_elev_3	int	гидропитание РА56 тангаж	1
			
sim/custom/switchers/eng/hydro_circuit_auto_man	int	кольцевание автомат - ручное	0
sim/custom/switchers/eng/hydro_long_control	int	продольная управляемость	1
sim/custom/switchers/eng/hydro_circuit_auto_man_cap	int	кольцевание автомат - ручное	0
sim/custom/switchers/eng/hydro_long_control_cap	int	продольная управляемость	0
			
sim/custom/buttons/eng/fire_ext_1	int	очередь тушения пожара	0
sim/custom/buttons/eng/fire_ext_2	int	очередь тушения пожара	0
sim/custom/buttons/eng/fire_ext_3	int	очередь тушения пожара	0
sim/custom/buttons/eng/cold_eng_1	int	подача хладона	0
sim/custom/buttons/eng/cold_eng_2	int	подача хладона	0
sim/custom/buttons/eng/cold_eng_3	int	подача хладона	0
sim/custom/buttons/eng/cold_apu	int	подача хладона	0
sim/custom/buttons/eng/neutral_gas	int	нейтральный газ	0
sim/custom/buttons/eng/smoke_test	int	подача хладона	0
sim/custom/buttons/eng/ext_test	int	подача хладона	0
sim/custom/switchers/eng/fire_sensor_sel	int	выбор группы датчиков	0
sim/custom/switchers/eng/fire_place_sel	int	выбор отсека	0
sim/custom/switchers/eng/fire_main_switch	int	выключатель пожарной системы	1
sim/custom/switchers/eng/fire_buzzer	int	пожарная сирена	1
sim/custom/switchers/eng/fire_buzzer_cap	int	пожарная сирена	0
			
sim/custom/switchers/eng/srd_buzzer	int	СРД сирена	1
sim/custom/switchers/eng/srd_buzzer_cap	int	СРД сирена	0
sim/custom/buttons/eng/srd_buzzer_test	int	проверка сирены СРД	0
sim/custom/switchers/eng/fuel_buzzer	int	сирена остатка топлива 2500кг	1
sim/custom/switchers/eng/fuel_buzzer_cap	int	сирена остатка топлива 2500кг	0
			
sim/custom/switchers/eng/soi21_on	int	выключатель СОИ 21	1
sim/custom/buttons/eng/soi21_test	int	проверка СОИ 21	0
			
sim/custom/switchers/eng/antiice_slats	int	противообледенители	0
sim/custom/switchers/eng/antiice_eng_1	int	противообледенители	0
sim/custom/switchers/eng/antiice_eng_2	int	противообледенители	0
sim/custom/switchers/eng/antiice_eng_3	int	противообледенители	0
sim/custom/switchers/eng/antiice_wing	int	противообледенители	0
			
sim/custom/gauges/eng/stab_temp	float	температура стабилизатора	20
sim/custom/gauges/eng/wing_temp	float	температура крыла	20
			
sim/custom/switchers/eng/sard_disable	int	перекрытие клапана сброса воздуха	0
sim/custom/switchers/eng/sard_disable_cap	int	перекрытие клапана сброса воздуха	0
			
sim/custom/gauges/eng/bus115_freq	float	частотомер сети 115в - угол	0
sim/custom/gauges/eng/bus115_volt	float	вольтметр сети 115в - угол	0
sim/custom/gauges/eng/bus115_amp	float	амерметр сети 115в - угол	0
sim/custom/switchers/eng/gpu_on	int	выключатель РАП	0
sim/custom/switchers/eng/apu_gen_on	int	выключатель ген ВСУ	0
sim/custom/switchers/eng/bus115_volt_sel	int	переключатель источника вольтметра	0
sim/custom/switchers/eng/bus115_volt_phase_sel	int	переключатель источника вольтметра	0
sim/custom/switchers/eng/bus115_amp_sel	int	переключатель источника амерметра	0
sim/custom/switchers/eng/bus115_amp_phase_sel	int	переключатель источника амерметра	0
			
sim/custom/switchers/eng/gen_1_on	int	выключатель генератора 1. -1 - проверка, 0 - выкл, +1 - вкл.	1
sim/custom/switchers/eng/gen_2_on	int	выключатель генератора 2. -1 - проверка, 0 - выкл, +1 - вкл.	1
sim/custom/switchers/eng/gen_3_on	int	выключатель генератора 3. -1 - проверка, 0 - выкл, +1 - вкл.	1
			
sim/custom/switchers/eng/emerg_inv115	int	аварийн. преобраз 115в	0
sim/custom/switchers/eng/emerg_inv115_cap	int	аварийн. преобраз 115в	0
			
sim/custom/gauges/eng/bus36_volt	float	вольтметр сети 36в - угол	0
sim/custom/switchers/eng/bus36_volt_sel	int	переключатель вольтметра 36в	0
sim/custom/switchers/eng/pts250_sel	int	переключатель ПТС250. 0 - №1, 1 - №2	0
sim/custom/switchers/eng/bus36_tr_left_to_right	int	лев сеть на тр2. 0 - авто, 1 - ручное	0
sim/custom/switchers/eng/bus36_tr_right_to_left	int	прав сеть на тр1	0
sim/custom/switchers/eng/pts250_on	int	выключатель ПТС250	0
sim/custom/switchers/eng/pts250_mode	int	режим ПТС250. авто - ручное	0
sim/custom/switchers/eng/pts250_on_cap	int	выключатель ПТС250	0
sim/custom/switchers/eng/pts250_mode_cap	int	режим ПТС250. авто - ручное	0
			
sim/custom/gauges/eng/bus27_volt	float	вольтметр сети 27в - угол	0
sim/custom/gauges/eng/bus27_amp1	float	амперметр сети 27в - угол	0
sim/custom/gauges/eng/bus27_amp2	float	амперметр сети 27в - угол	0
sim/custom/switchers/eng/bus27_volt_sel	int	переключатель вольтметра 27в	0
sim/custom/switchers/eng/bus27_amp1_sel	int	переключатель амперметра 27в	0
sim/custom/switchers/eng/bus27_amp2_sel	int	переключатель амперметра 27в	0
sim/custom/switchers/eng/bus27_connect	int	соединение сетей 27в	0
sim/custom/switchers/eng/bus27_connect_cap	int	соединение сетей 27в	0
sim/custom/switchers/eng/bus27_vu1	int	ВУ1. -1 - резерв, 0 - выкл, +1 - вкл.	1
sim/custom/switchers/eng/bus27_vu2	int	ВУ2. -1 - резерв, 0 - выкл, +1 - вкл.	1
sim/custom/switchers/eng/bat1_on	int	батарея 1	1
sim/custom/switchers/eng/bat2_on	int	батарея 2	1
sim/custom/switchers/eng/bat3_on	int	батарея 3	1
sim/custom/switchers/eng/bat4_on	int	батарея 4	1
			
sim/custom/switchers/eng/apu_main_switch	int	выключатель ВСУ	0
sim/custom/switchers/eng/apu_start_mode	int	режим запуска ВСУ	0
sim/custom/switchers/eng/apu_air_bleed	int	переключение заслонки отбора воздуха. -1 - закрыть, 0 - нейтр, +1 - открыть	0
sim/custom/buttons/eng/apu_start	int	кнопка старта ВСУ	0
sim/custom/buttons/eng/apu_stop	int	кнопка стоп ВСУ	0
sim/custom/gauges/eng/apu_rpm	float	обороты ВСУ	0
sim/custom/gauges/eng/apu_egt	float	ТВГ ВСУ	0
sim/custom/gauges/eng/apu_oil_temp	float	температура масла ВСУ	0
			
sim/custom/gauges/eng/egt_1	float	ТВГ двиг 1	20
sim/custom/gauges/eng/egt_2	float	ТВГ двиг 2	20
sim/custom/gauges/eng/egt_3	float	ТВГ двиг 3	20
			
sim/custom/gauges/eng/fuel_press_1	float	давление топлива двиг 1	0
sim/custom/gauges/eng/fuel_press_2	float	давление топлива двиг 2	0
sim/custom/gauges/eng/fuel_press_3	float	давление топлива двиг 3	0
sim/custom/gauges/eng/oil_press_1	float	давление масла двиг 1	0
sim/custom/gauges/eng/oil_press_2	float	давление масла двиг 2	0
sim/custom/gauges/eng/oil_press_3	float	давление масла двиг 3	0
sim/custom/gauges/eng/oil_temp_1	float	температура масла двиг 1	0
sim/custom/gauges/eng/oil_temp_2	float	температура масла двиг 2	0
sim/custom/gauges/eng/oil_temp_3	float	температура масла двиг 3	0
			
sim/custom/gauges/eng/fuel_flow_1	float	расход топлива двиг 1	0
sim/custom/gauges/eng/fuel_flow_2	float	расход топлива двиг 2	0
sim/custom/gauges/eng/fuel_flow_3	float	расход топлива двиг 3	0
sim/custom/gauges/eng/vibra_1	float	вибрация двиг 1	0
sim/custom/gauges/eng/vibra_2	float	вибрация двиг 2	0
sim/custom/gauges/eng/vibra_3	float	вибрация двиг 3	0
			
sim/custom/buttons/eng/control_ut	int	кнопка контроль УТ	0
sim/custom/buttons/eng/control_vibro_1	int	кнопка контроль вибрации	0
sim/custom/buttons/eng/control_vibro_2	int	кнопка контроль вибрации	0
sim/custom/buttons/eng/control_vibro_3	int	кнопка контроль вибрации	0
sim/custom/switchers/eng/vibro_sel_1	int	переключатель прибора вибрации	0
sim/custom/switchers/eng/vibro_sel_2	int	переключатель прибора вибрации	0
sim/custom/switchers/eng/vibro_sel_3	int	переключатель прибора вибрации	0
			
sim/custom/gauges/fuel/fuel_meter_summ	float	сумарная масса топлива	0
sim/custom/gauges/fuel/fuel_meter_tank1	float	масса топлива в баке 1	0
sim/custom/gauges/fuel/fuel_meter_tank2_left	float	масса топлива в баке 2	0
sim/custom/gauges/fuel/fuel_meter_tank2_right	float	масса топлива в баке 2	0
sim/custom/gauges/fuel/fuel_meter_tank3_left	float	масса топлива в баке 3	0
sim/custom/gauges/fuel/fuel_meter_tank3_right	float	масса топлива в баке 3	0
sim/custom/gauges/fuel/fuel_meter_tank4	float	масса топлива в баке 4	0
sim/custom/gauges/fuel/fuel_meter_mech	float	расходомер	0
			
sim/custom/buttons/fuel/fuel_meter_summ_zero	int	сумарная масса топлива. кнопка нуля	0
sim/custom/buttons/fuel/fuel_meter_summ_max	int	сумарная масса топлива. кнопка P	0
sim/custom/buttons/fuel/fuel_meter_tank2_zero	int	топливомер бака 2. кнопка нуля	0
sim/custom/buttons/fuel/fuel_meter_tank2_max	int	топливомер бака 2. кнопка P	0
sim/custom/buttons/fuel/fuel_meter_tank3_zero	int	топливомер бака 3. кнопка нуля	0
sim/custom/buttons/fuel/fuel_meter_tank3_max	int	топливомер бака 3. кнопка P	0
sim/custom/buttons/fuel/fuel_meter_tank4_zero	int	топливомер бака 4. кнопка нуля	0
sim/custom/buttons/fuel/fuel_meter_tank4_max	int	топливомер бака 4. кнопка P	0
			
sim/custom/switchers/fuel/pump_tank2_left	int	насосы бака 2	1
sim/custom/switchers/fuel/pump_tank2_right	int	насосы бака 2	1
sim/custom/switchers/fuel/pump_tank3_left	int	насосы бака 3	1
sim/custom/switchers/fuel/pump_tank3_right	int	насосы бака 3	1
sim/custom/switchers/fuel/pump_tank4	int	насосы бака 4	1
sim/custom/switchers/fuel/pump_tank1_1	int	насосы бака 1	1
sim/custom/switchers/fuel/pump_tank1_2	int	насосы бака 1	1
sim/custom/switchers/fuel/pump_tank1_3	int	насосы бака 1	1
sim/custom/switchers/fuel/pump_tank1_4	int	насосы бака 1	1
			
sim/custom/switchers/fuel/fuel_trans	int	краны резервой перекачки	0
sim/custom/switchers/fuel/fuel_trans_cap	int	краны резервой перекачки	0
sim/custom/switchers/fuel/fuel_porc	int	принуд порц	0
sim/custom/switchers/fuel/fuel_porc_cap	int	принуд порц	0
sim/custom/switchers/fuel/fuel_level	int	автомат выравнивания	1
sim/custom/switchers/fuel/fuel_flow_mode	int	режим расходомера. ручное - автомат	1
sim/custom/switchers/fuel/fuel_flow_on	int	автомат расхода	1
sim/custom/switchers/fuel/fuel_flow_on_cap	int	автомат расхода	0
sim/custom/switchers/fuel/fuel_meter_on	int	топливомер	1
sim/custom/switchers/fuel/fuel_meter_mech_on	int	расходомер	1
sim/custom/switchers/fuel/fire_valve_1	int	пожарный кран	1
sim/custom/switchers/fuel/fire_valve_2	int	пожарный кран	1
sim/custom/switchers/fuel/fire_valve_3	int	пожарный кран	1
sim/custom/switchers/fuel/fire_valve_1_cap	int	пожарный кран	0
sim/custom/switchers/fuel/fire_valve_2_cap	int	пожарный кран	0
sim/custom/switchers/fuel/fire_valve_3_cap	int	пожарный кран	0
			
sim/custom/gauges/hydro/qty_12	float	гидробаки	0
sim/custom/gauges/hydro/qty_3	float	гидробаки	0
sim/custom/switchers/hydro/connect2to1	int	подключение 2 ГС на 1 ГС	0
sim/custom/switchers/hydro/connect2to1_cap	int	подключение 2 ГС на 1 ГС	0
sim/custom/switchers/hydro/pump_2	int	гидронасосы 2	0
sim/custom/switchers/hydro/pump_3	int	гидронасосы 3	0
sim/custom/buttons/hydro/qty_test_12	int	контроль уровня	0
sim/custom/buttons/hydro/qty_test_3	int	контроль уровня	0
sim/custom/buttons/hydro/accum_fill	int	зарядка аккумулятора	0
			
sim/custom/gauges/airbleed/cabin_alt	float	высота в кабине	0
sim/custom/gauges/airbleed/cabin_diff	float	перепад давления	0
sim/custom/gauges/airbleed/cabin_vvi	float	кабинный вариометр. угол	0
sim/custom/gauges/airbleed/cockpit_temp	float	температура в кабине	20
sim/custom/gauges/airbleed/cabin_temp	float	температура в салонах	20
sim/custom/gauges/airbleed/system_temp	float	температура в трубопроводе	20
sim/custom/gauges/airbleed/air_flow_1	float	расход воздуха. угол	0
sim/custom/gauges/airbleed/air_flow_2	float	расход воздуха. угол	0
			
sim/custom/switchers/airbleed/cabin_sel	int	выбор салона	0
sim/custom/switchers/airbleed/cockpit_temp_set	int	установка температуры кабины	20
sim/custom/switchers/airbleed/cabin1_temp_set	int	установка температуры салона	20
sim/custom/switchers/airbleed/cabin2_temp_set	int	установка температуры салона	20
sim/custom/switchers/airbleed/cockpit_mode_set	int	установка режима обогрева. 0 - нейтр. 1 - авто, 2 - хол, 3 - гор	1
sim/custom/switchers/airbleed/cabin1_mode_set	int	установка режима обогрева	1
sim/custom/switchers/airbleed/cabin2_mode_set	int	установка режима обогрева	1
sim/custom/switchers/airbleed/heat_close	int	прекращение обогрева	0
sim/custom/switchers/airbleed/heat_close_cap	int	прекращение обогрева	0
sim/custom/switchers/airbleed/left_sys_temp_set	int	установка температуры левой магистрали	22
sim/custom/switchers/airbleed/right_sys_temp_set	int	установка температуры правой магистрали	22
sim/custom/switchers/airbleed/left_sys_mode_set	int	установка режима левой магистрали	1
sim/custom/switchers/airbleed/right_sys_mode_set	int	установка режима правой магистрали	1
sim/custom/switchers/airbleed/ground_cond_on	int	наземное кондиционирование	0
sim/custom/switchers/airbleed/ground_cond_on_cap	int	наземное кондиционирование	0
sim/custom/switchers/airbleed/skv_faster_work	int	-1 - охлаждение ГК, 0 - выкл, +1 - ускоренноые режимы обогрева	0
sim/custom/switchers/airbleed/skv_faster_work_cap	int	крышка	0
sim/custom/switchers/airbleed/sys_temp_select	int	переключение источников термометра. 0 - обогрев дверей, 1 - экип, 2 - салон 1, 3 - салон 2, 4 - маг лев, 5 - маг прав	1
	 		
sim/custom/switchers/airbleed/psvp_left_on	int	ПСВП лев	1
sim/custom/switchers/airbleed/psvp_right_on	int	ПСВП прав	1
sim/custom/switchers/airbleed/psvp_left_on_cap	int	ПСВП лев	0
sim/custom/switchers/airbleed/psvp_right_on_cap	int	ПСВП прав	0
sim/custom/switchers/airbleed/air_valve_left	int	краны наддува. -1 закр, 0 - нейтр, +1 откр	0
sim/custom/switchers/airbleed/air_valve_right	int	краны наддува. -1 закр, 0 - нейтр, +1 откр	0
sim/custom/switchers/airbleed/air_valve_both	int	краны наддува. -1 закр, 0 - нейтр, +1 откр	0
sim/custom/switchers/airbleed/emerg_decompress	int	сброс давления	0
sim/custom/switchers/airbleed/emerg_decompress_cap	int	сброс давления	0
sim/custom/switchers/airbleed/eng_valve_1	int	отбор воздуха от двигателей	1
sim/custom/switchers/airbleed/eng_valve_2	int	отбор воздуха от двигателей	1
sim/custom/switchers/airbleed/eng_valve_3	int	отбор воздуха от двигателей	1
sim/custom/switchers/airbleed/dubler_on	int	дублер	0
sim/custom/switchers/airbleed/dubler_on_cap	int	дублер	0
			
sim/custom/gauges/eng/starter_press	float	давление в системе запуска	0
sim/custom/switchers/eng/starter_cap	int	крышка панели запуска	0
sim/custom/switchers/eng/starter_switch	int	выключатель запуска	0
sim/custom/switchers/eng/starter_eng_select	int	выбор двигателя	0
sim/custom/switchers/eng/starter_mode	int	режим запуска	0
sim/custom/buttons/eng/starter_start	int	кнопка запуска	0
sim/custom/buttons/eng/starter_stop	int	кнопка преркащения запуска	0
sim/custom/buttons/eng/flight_start_1	int	запуск в полете	0
sim/custom/buttons/eng/flight_start_2	int	запуск в полете	0
sim/custom/buttons/eng/flight_start_3	int	запуск в полете	0
sim/custom/switchers/eng/gauges_on_1	int	приборы контроля двигателей	1
sim/custom/switchers/eng/gauges_on_2	int	приборы контроля двигателей	1
sim/custom/switchers/eng/gauges_on_3	int	приборы контроля двигателей	1
sim/custom/switchers/eng/gauges_on_1_cap	int	приборы контроля двигателей	0
sim/custom/switchers/eng/gauges_on_2_cap	int	приборы контроля двигателей	0
sim/custom/switchers/eng/gauges_on_3_cap	int	приборы контроля двигателей	0
sim/custom/buttons/eng/reserv_pump_test	int	проверка резерв топл насоса	0
			
sim/custom/buttons/console/absu_zk	int	кнопка ЗК на панели АБСУ	0
sim/custom/buttons/console/absu_reset	int	кнопка сброс программы на панели АБСУ	0
sim/custom/buttons/console/absu_nvu	int	кнопка НВУ на панели АБСУ	0
sim/custom/buttons/console/absu_az1	int	кнопка АЗ 1 на панели АБСУ	0
sim/custom/buttons/console/absu_az2	int	кнопка АЗ 2 на панели АБСУ	0
sim/custom/buttons/console/absu_app	int	кнопка заход на панели АБСУ	0
sim/custom/buttons/console/absu_gs	int	кнопка глиссада на панели АБСУ	0
sim/custom/buttons/console/absu_stab_m	int	кнопка M на панели АБСУ	0
sim/custom/buttons/console/absu_stab_v	int	кнопка V на панели АБСУ	0
sim/custom/buttons/console/absu_stab_h	int	кнопка H на панели АБСУ	0
sim/custom/buttons/console/absu_stab	int	кнопка СТАБ на панели АБСУ	0
sim/custom/buttons/console/absu_stab_speed	int	кнопка C на панели АБСУ	0
sim/custom/buttons/console/absu_throt_off_1	int	кнопка откл Г1 на панели АБСУ	0
sim/custom/buttons/console/absu_throt_off_2	int	кнопка откл Г2 на панели АБСУ	0
sim/custom/buttons/console/absu_throt_off_3	int	кнопка откл Г3 на панели АБСУ	0
			
sim/custom/gauges/console/absu_roll_mode	int	режим работы АБСУ. 0 - выкл, 1 - штурвальный, 2 - стаб	0
sim/custom/gauges/console/absu_pitch_mode	int	режим работы АБСУ. 0 - выкл, 1 - штурвальный, 2 - стаб	0
			
sim/custom/gauges/console/gear_brake_press_L	float	давление тормозов лев	0
sim/custom/gauges/console/gear_brake_press_R	float	давление тормозов прав	0
sim/custom/gauges/console/map_angle	float	угол карты	0
			
sim/custom/switchers/console/buster_on_1	int	выключатель бустера	1
sim/custom/switchers/console/buster_on_2	int	выключатель бустера	1
sim/custom/switchers/console/buster_on_3	int	выключатель бустера	1
sim/custom/switchers/console/busters_cap	int	крышка выключателей бустеров	0
			
sim/custom/switchers/console/rls_on	int	выключатель РЛС	1
sim/custom/switchers/console/rls_mode	int	режимы РЛС. 0 -готов, 1 - метео	0
sim/custom/switchers/console/rls_distance	int	дистанции РЛС	4
sim/custom/switchers/console/rls_brt	float	яркость РЛС	1
sim/custom/switchers/console/rls_contr	float	контраст РЛС	1
sim/custom/switchers/console/rls_signs	float	яркость меток РЛС	1
			
sim/custom/switchers/console/absu_zpu_sel	int	переключатель ЗПУ. лев - прав	0
sim/custom/switchers/console/absu_nav_on	int	стрелки навигация	1
sim/custom/switchers/console/absu_landing_on	int	стрелки посадка	0
sim/custom/switchers/console/absu_needles_on	int	стрелки	1
sim/custom/switchers/console/absu_speed_mode	int	режим СТУ. 0 - откл, 1 - нву, 2 - аз1, 3 - аз2, 4 - пос	0
sim/custom/switchers/console/absu_speed_change	int	ручка изменения скорости. 	0
sim/custom/switchers/console/absu_speed_off	int	отключение 1 и 2	0
sim/custom/switchers/console/absu_speed_prepare	int	подготовка	1
sim/custom/switchers/console/absu_speed_off_cap	int	отключение 1 и 2	0
sim/custom/switchers/console/absu_speed_prepare_cap	int	подготовка	0
sim/custom/switchers/console/absu_speed_us_right_left	int	подготовка	1
sim/custom/buttons/console/absu_speed_test_1	int	кнопка првоерки СТУ нижняя	0
sim/custom/buttons/console/absu_speed_test_2	int	кнопка првоерки СТУ верхняя	0
			
sim/custom/switchers/console/absu_turn_handle	int	ручка поворота	0
sim/custom/switchers/console/absu_pitch_wheel	float	колесико спуска, подъема	0
sim/custom/switchers/console/absu_roll_ch_on	int	выключатель канал крена	1
sim/custom/switchers/console/absu_pitch_ch_on	int	выключатель канала тангажа	1
sim/custom/switchers/console/absu_smooth_on	int	выключатель "в болтанку"	0
sim/custom/switchers/console/absu_smooth_on_cap	int	выключатель "в болтанку"	0
sim/custom/switchers/console/absu_pitch_wheel_dir	int	направление колесика спуска, подъема	0
			
sim/custom/buttons/console/absu_arrest	int	кнопки арретирования	0
sim/custom/buttons/console/absu_arrest_cap	int	крышка кнопок арретирования	0
			
sim/custom/switchers/console/nvu_param_sel	int	ручка выбора вводимого параметра НВУ. -4 - Z, -3 - S, -2 - Zm, -1 - Sm, 0 - off, 1 - Sn, 2 - Zn, 3 - S, 4 - Z	0
sim/custom/switchers/console/nvu_turn_sel	int	ручка выбора радиуса разворота, -1 - принуд, 0 - выкл, 1 - 5, 2 - 10, 3 - 15, 4 - 20, 5 - 25	0
sim/custom/switchers/console/nvu_power_on	int	питание НВУ	1
sim/custom/switchers/console/nvu_calc_on	int	счисление НВУ	0
sim/custom/switchers/console/nvu_corr_on	int	коррекция НВУ	0

		
sim/custom/nvu/current_Z1_1	float	Z1	4
sim/custom/nvu/current_Z1_10	float	Z1	3
sim/custom/nvu/current_Z1_100	float	Z1	2
sim/custom/nvu/current_Z1_1000	float	Z1	1
			
sim/custom/nvu/current_Z1_min_1	float	Z1	4
sim/custom/nvu/current_Z1_min_10	float	Z1	3
sim/custom/nvu/current_Z1_min_100	float	Z1	2
sim/custom/nvu/current_Z1_min_1000	float	Z1	1
			
sim/custom/nvu/current_S1_1	float	S1	4
sim/custom/nvu/current_S1_10	float	S1	3
sim/custom/nvu/current_S1_100	float	S1	2
sim/custom/nvu/current_S1_1000	float	S1	1
			
sim/custom/nvu/current_S1_min_1	float	S1	4
sim/custom/nvu/current_S1_min_10	float	S1	3
sim/custom/nvu/current_S1_min_100	float	S1	2
sim/custom/nvu/current_S1_min_1000	float	S1	1
			
sim/custom/nvu/next_Z1_1	float	Z1	4
sim/custom/nvu/next_Z1_10	float	Z1	3
sim/custom/nvu/next_Z1_100	float	Z1	2
sim/custom/nvu/next_Z1_1000	float	Z1	1
			
sim/custom/nvu/next_Z1_min_1	float	Z1	4
sim/custom/nvu/next_Z1_min_10	float	Z1	3
sim/custom/nvu/next_Z1_min_100	float	Z1	2
sim/custom/nvu/next_Z1_min_1000	float	Z1	1
			
sim/custom/nvu/next_S1_1	float	S1	4
sim/custom/nvu/next_S1_10	float	S1	3
sim/custom/nvu/next_S1_100	float	S1	2
sim/custom/nvu/next_S1_1000	float	S1	1
			
sim/custom/nvu/next_S1_min_1	float	S1	4
sim/custom/nvu/next_S1_min_10	float	S1	3
sim/custom/nvu/next_S1_min_100	float	S1	2
sim/custom/nvu/next_S1_min_1000	float	S1	1
			
			
sim/custom/nvu/current_Z2_1	float	Z2	4
sim/custom/nvu/current_Z2_10	float	Z2	3
sim/custom/nvu/current_Z2_100	float	Z2	2
sim/custom/nvu/current_Z2_1000	float	Z2	1
			
sim/custom/nvu/current_S2_1	float	S2	4
sim/custom/nvu/current_S2_10	float	S2	3
sim/custom/nvu/current_S2_100	float	S2	2
sim/custom/nvu/current_S2_1000	float	S2	1
			
sim/custom/nvu/next_Z2_1	float	Z2	4
sim/custom/nvu/next_Z2_10	float	Z2	3
sim/custom/nvu/next_Z2_100	float	Z2	2
sim/custom/nvu/next_Z2_1000	float	Z2	1
			
sim/custom/nvu/next_S2_1	float	S2	4
sim/custom/nvu/next_S2_10	float	S2	3
sim/custom/nvu/next_S2_100	float	S2	2
sim/custom/nvu/next_S2_1000	float	S2	1
			
sim/custom/nvu/current_Z2_min_1	float	Z2	4
sim/custom/nvu/current_Z2_min_10	float	Z2	3
sim/custom/nvu/current_Z2_min_100	float	Z2	2
sim/custom/nvu/current_Z2_min_1000	float	Z2	1
			
sim/custom/nvu/current_S2_min_1	float	S2	4
sim/custom/nvu/current_S2_min_10	float	S2	3
sim/custom/nvu/current_S2_min_100	float	S2	2
sim/custom/nvu/current_S2_min_1000	float	S2	1
			
sim/custom/nvu/next_Z2_min_1	float	Z2	4
sim/custom/nvu/next_Z2_min_10	float	Z2	3
sim/custom/nvu/next_Z2_min_100	float	Z2	2
sim/custom/nvu/next_Z2_min_1000	float	Z2	1
			
sim/custom/nvu/next_S2_min_1	float	S2	4
sim/custom/nvu/next_S2_min_10	float	S2	3
sim/custom/nvu/next_S2_min_100	float	S2	2
sim/custom/nvu/next_S2_min_1000	float	S2	1
			
sim/custom/nvu/zpu1_01	float	ZPU	5
sim/custom/nvu/zpu1_1	float	ZPU	3
sim/custom/nvu/zpu1_10	float	ZPU	2
sim/custom/nvu/zpu1_100	float	ZPU	1
			
sim/custom/nvu/zpu2_01	float	ZPU	5
sim/custom/nvu/zpu2_1	float	ZPU	3
sim/custom/nvu/zpu2_10	float	ZPU	2
sim/custom/nvu/zpu2_100	float	ZPU	1
			
sim/custom/nvu/z1_minus_cap	float	digits cap	1
sim/custom/nvu/z1_plus_cap	float	digits cap	1
sim/custom/nvu/s1_minus_cap	float	digits cap	1
sim/custom/nvu/s1_plus_cap	float	digits cap	1
			
sim/custom/nvu/z2_minus_cap	float	digits cap	1
sim/custom/nvu/z2_plus_cap	float	digits cap	1
sim/custom/nvu/s2_minus_cap	float	digits cap	1
sim/custom/nvu/s2_plus_cap	float	digits cap	1
			
sim/custom/nvu/z1_next_minus_cap	float	digits cap	1
sim/custom/nvu/z1_next_plus_cap	float	digits cap	1
sim/custom/nvu/s1_next_minus_cap	float	digits cap	1
sim/custom/nvu/s1_next_plus_cap	float	digits cap	1
			
sim/custom/nvu/z2_next_minus_cap	float	digits cap	1
sim/custom/nvu/z2_next_plus_cap	float	digits cap	1
sim/custom/nvu/s2_next_minus_cap	float	digits cap	1
sim/custom/nvu/s2_next_plus_cap	float	digits cap	1

sim/custom/buttons/nvu/nvu_left_btn	int	левая кнопка НВУ	0
sim/custom/buttons/nvu/nvu_ctr_btn	int	центр кнопка НВУ	0
sim/custom/buttons/nvu/nvu_right_btn	int	правая кнопка НВУ	0
			
sim/custom/buttons/nvu/zpu_1_left_btn	int	левая кнопка ЗПУ	0
sim/custom/buttons/nvu/zpu_1_ctr_btn	int	центр кнопка ЗПУ	0
sim/custom/buttons/nvu/zpu_1_right_btn	int	правая кнопка ЗПУ	0
			
sim/custom/buttons/nvu/zpu_2_left_btn	int	левая кнопка ЗПУ	0
sim/custom/buttons/nvu/zpu_2_ctr_btn	int	центр кнопка ЗПУ	0
sim/custom/buttons/nvu/zpu_2_right_btn	int	правая кнопка ЗПУ	0
			
sim/custom/rotary/console/nav_1_course	int	курс нав 1	0
sim/custom/rotary/console/nav_1_course_1	float	курс нав 1	0
sim/custom/rotary/console/nav_1_course_10	float	курс нав 1	0
sim/custom/rotary/console/nav_1_course_100	float	курс нав 1	0
sim/custom/rotary/console/nav_2_course	int	курс нав 2	0
sim/custom/rotary/console/nav_2_course_1	float	курс нав 2	0
sim/custom/rotary/console/nav_2_course_10	float	курс нав 2	0
sim/custom/rotary/console/nav_2_course_100	float	курс нав 2	0
sim/custom/rotary/console/wind_set	float	установка ветра	0

sim/custom/button/console/wind_course_left	int	кнопка установки курса ветра 	0
sim/custom/button/console/wind_course_ctr	int	кнопка установки курса ветра 	0
sim/custom/button/console/wind_course_right	int	кнопка установки курса ветра 	0
sim/custom/button/console/wind_spd_left	int	кнопка установки скорости ветра 	0
sim/custom/button/console/wind_spd_ctr	int	кнопка установки скорости ветра	0
sim/custom/button/console/wind_spd_right	int	кнопка установки скорости ветра	0
			
sim/custom/switchers/console/emerg_elev_trimm	int	аварийное управление триммером	0
sim/custom/switchers/console/emerg_elev_trimm_cap	int	аварийное управление триммером	0
			
sim/custom/buttons/console/radio	int	кнопка радио на пъедестале	0
sim/custom/buttons/console/pdu406_control	int	кнопка дежур-контроль	0
sim/custom/buttons/console/pdu406_sound_off	int	кнопка отключение звука	0
			
sim/custom/switchers/sard/sard_cabin_press_set	float	установка давления в кабине	650
sim/custom/switchers/sard/sard_abs_press_set	float	установка абсолютного давления	1013
sim/custom/switchers/sard/sard_diff_set	float	установка перепада давлений	0.6
sim/custom/switchers/sard/sard_spd_set	float	установка скорости работы САРД	0.5

sim/custom/switchers/tcas/tcas_mode	int	режим TCAS. -1 = test, 0 - stby, 1 = alt off, 2 = alt on, 3 = TA, 4 = TARA	4
sim/custom/switchers/tcas/tcas_rot_big	int	большая вертелка	0
sim/custom/switchers/tcas/tcas_rot_small	int	малая вертелка	0
sim/custom/buttons/tcas/tcas_ident_btn	int	кнопка IDENT	0
sim/custom/buttons/tcas/tcas_fcn_btn	int	кнопка FCN	0
sim/custom/buttons/tcas/tcas_left_btn	int	кнопка <	0
sim/custom/buttons/tcas/tcas_right_btn	int	кнопка >	0
sim/custom/buttons/tcas/tcas_ent_btn	int	кнопка ENT	0
sim/custom/buttons/tcas/tcas_atc_btn	int	кнопка ATC	0
sim/custom/buttons/tcas/tcas_alt_btn	int	кнопка ALT	0
sim/custom/buttons/tcas/tcas_rng_dn_btn	int	кнопка RNG DN	0
sim/custom/buttons/tcas/tcas_rng_up_btn	int	кнопка RNG UP	0

sim/custom/buttons/srpbz/but_view	int	кнопка ВИД	0
sim/custom/buttons/srpbz/but_empty	int	кнопка -	0
sim/custom/buttons/srpbz/but_down	int	кнопка масштаб вниз	0
sim/custom/buttons/srpbz/but_up	int	кнопка масштаб вверх	0
sim/custom/rotary/srpbz/brightness	float	ручка яркости	0.7


sim/custom/light/no_LIT	float	переменная для отключения светимости у объектов, которые имеют LIT текстуру, но светиться не должны	0
			
sim/custom/lights/exit_lamp	float	лампа выхода	0
sim/custom/lights/fasten_seatbelts_lamp	float	лампа пристегните ремни	0
sim/custom/lights/nosmoking_lamp	float	лампа не курить	0
sim/custom/lights/toilet_busy_lamp	float	лампа туалет занят	0
sim/custom/lights/seats_leters_lamp	float	лампы с буквами кресел	0

	
sim/custom/lights/mid_left_panel_int	float	яркость свечения пъедестала	0
sim/custom/lights/left_panel_int	float	яркость свечения встроенного освещения панели КВС	0
sim/custom/lights/right_panel_int	float	яркость свечения встроенного освещения панели 2П	0
sim/custom/lights/mid_right_panel_int	float	яркость свечения встроенного освещения средней передней панели	0
sim/custom/lights/ovhd_panel_int	float	яркость свечения встроенного освещения верхней панели	0
sim/custom/lights/left_panel_flood	float	яркость заливающего света левой панели	0
sim/custom/lights/right_panel_flood	float	яркость заливающего света правой панели	0
sim/custom/lights/mid_panel_flood	float	яркость заливающего света центральной панели	0
sim/custom/lights/front_panel_flood	float	яркость заливающего света передней панели	0
sim/custom/lights/ovhd_front_panel_flood	float	яркость заливающего света передней части оверхеда	0
sim/custom/lights/ovhd_back_panel_flood	float	яркость заливающего света задней части оверхеда	0
sim/custom/lights/eng_panel_flood	float	яркость освещения панели БИ	0
sim/custom/lights/azs_panel_flood	float	освещение панели АЗС	0
sim/custom/lights/cargo_light_1	float	освещение грузового отсека 1	0
sim/custom/lights/cargo_light_2	float	освещение грузового отсека 2	0
sim/custom/lights/tech_light	float	отсвещение тех-отсека	0
sim/custom/lights/gear_nacelle_light	float	освещение гондол шасси	0
sim/custom/lights/left_spotlight_flood	float	яркость левого фонарика	0
			
sim/custom/lights/ark1_left_lit	float	подсветка левой части АРК 1	0
sim/custom/lights/ark1_right_lit	float	подсветка правой части АРК 1	0
sim/custom/lights/ark1_all_lit	float	подсветка АРК 1	0
			
sim/custom/lights/ark2_left_lit	float	подсветка левой части АРК 2	0
sim/custom/lights/ark2_right_lit	float	подсветка правой части АРК 2	0
sim/custom/lights/ark2_all_lit	float	подсветка АРК 2	0
			
sim/custom/lights/tks_mode_lit_mk	float	лампочка режима ТКС - МК	0
sim/custom/lights/tks_mode_lit_ak	float	лампочка режима ТКС - АК	0
sim/custom/lights/tks_mode_lit_gpk	float	лампочка режима ТКС - ГПК	0
			
sim/custom/lights/to_not_ready	float	к взлету не готов	0
sim/custom/lights/wrong_trimm	float	ложное триммирование	0
sim/custom/lights/controll_roll	float	управляй креном	0
sim/custom/lights/controll_pitch	float	управляй тангажом	0
sim/custom/lights/yoke_sign	float	сигнализация ухода на второй круг в штурвальном режиме	0
sim/custom/lights/triangle	float	интегральный сигнальный огонь	0
sim/custom/lights/controll_thrust	float	управляй тягой	0
sim/custom/lights/course_lim	float	выход за пределы курса	0
sim/custom/lights/gs_lim	float	выход за пределы глиссады	0
sim/custom/lights/fire	float	ПОЖАР	0
sim/custom/lights/no_ag_controll	float	нет контроля АГ	0
sim/custom/lights/fuel_less_2500	float	остаток топлива 2500	0
sim/custom/lights/sso_danger	float	ССО опасно	0
sim/custom/lights/sso_connect	float	ССО связь	0
sim/custom/lights/speed_high	float	предел скорости	0
sim/custom/lights/roll_left_high	float	крен лев велик	0
sim/custom/lights/roll_right_high	float	крен прав велик	0
sim/custom/lights/alpha_high	float	предельный УА	0
sim/custom/lights/g_force_high	float	передельная перегрузка	0
sim/custom/lights/auasp_lamp	float	лампа на АУАСП	0
sim/custom/lights/toga	float	уход	0
sim/custom/lights/decision_height	float	ССО связьвысота принятия решения Н	0
			
sim/custom/lights/course	float	КУРС	0
sim/custom/lights/glideslope	float	ГЛИСС	0
sim/custom/lights/zk_lamp	float	ЗК	0
sim/custom/lights/thrust_automat	float	автомат тяги	0
sim/custom/lights/stab_roll	float	стабилизация боков	0
sim/custom/lights/stab_pitch	float	стабилизация продольная	0
sim/custom/lights/nvu_lamp	float	НВУ	0
sim/custom/lights/vor_lamp	float	VOR	0
sim/custom/lights/stab_h	float	стаб H	0
sim/custom/lights/stab_v	float	стаб V	0
sim/custom/lights/stab_m	float	стаб M	0
sim/custom/lights/marker_1	float	маркер 1	0
sim/custom/lights/marker_2	float	маркер 2	0
sim/custom/lights/marker_3	float	маркер 3	0
			
sim/custom/lights/pull_up	float	тяни вверх	0
sim/custom/lights/check_alt_left	float	проверь Н	0
sim/custom/lights/check_alt_right	float	проверь Н	0
sim/custom/lights/sns_lamp	float	СНС	0
sim/custom/lights/fp_eng_fail_1	float	двиг. неиспр 1 на передней панели	0
sim/custom/lights/fp_eng_fail_2	float	двиг. неиспр 2 на передней панели	0
sim/custom/lights/fp_eng_fail_3	float	двиг. неиспр 3 на передней панели	0
sim/custom/lights/fp_reverse_1	float	створки реверса 1 на передней панели	0
sim/custom/lights/fp_reverse_3	float	створки реверса 3 на передней панели	0
sim/custom/lights/stab_work	float	стабилиз включен	0
sim/custom/lights/flaps_1_valve	float	закрылки 1 ПК	0
sim/custom/lights/flaps_2_valve	float	закрылки 2 ПК	0
sim/custom/lights/spoilers_mid_left	float	интерцепторы средн лев	0
sim/custom/lights/spoilers_mid_right	float	интерцепторы средн прав	0
sim/custom/lights/spoilers_inn_left	float	интерцепторы внутр лев	0
sim/custom/lights/spoilers_inn_right	float	интерцепторы внутр прав	0
sim/custom/lights/gears_not_ext	float	шасси не выпущенны	0
sim/custom/lights/gears_red_left	float	красная лампа шасси	0
sim/custom/lights/gears_red_front	float	красная лампа шасси	0
sim/custom/lights/gears_red_right	float	красная лампа шасси	0
sim/custom/lights/gears_green_left	float	зеленая лампа шасси	0
sim/custom/lights/gears_green_front	float	зеленая лампа шасси	0
sim/custom/lights/gears_green_right	float	зеленая лампа шасси	0
sim/custom/lights/gears_red_left_eng	float	красная лампа шасси на панели БИ	0
sim/custom/lights/gears_red_front_eng	float	красная лампа шасси на панели БИ	0
sim/custom/lights/gears_red_right_eng	float	красная лампа шасси на панели БИ	0
sim/custom/lights/gears_green_left_eng	float	зеленая лампа шасси на панели БИ	0
sim/custom/lights/gears_green_front_eng	float	зеленая лампа шасси на панели БИ	0
sim/custom/lights/gears_green_right_eng	float	зеленая лампа шасси на панели БИ	0
sim/custom/lights/flaps_unsync	float	рассинхр закрылки	0
sim/custom/lights/slats_unsync	float	рассинхр предкр	0
sim/custom/lights/slats_extended	float	предкрылки выпущены	0
			
sim/custom/lights/to_rudder	float	взлет-посадка РН	0
sim/custom/lights/to_elevator	float	взлет-посадка РВ	0
sim/custom/lights/trimm_zero_course	float	нетрально курс	0
sim/custom/lights/trimm_zero_roll	float	нетрально крен	0
sim/custom/lights/trimm_zero_pitch	float	нетрально тангаж	0
sim/custom/lights/damper_course	float	демпер курс	0
sim/custom/lights/damper_roll	float	демпер крен	0
sim/custom/lights/damper_pitch	float	демпер тангаж	0
sim/custom/lights/no_reserve_c	float	нет резерва К	0
sim/custom/lights/no_reserve_g	float	нет резерва Г	0
sim/custom/lights/pitch_control_fail	float	продол управл	0
sim/custom/lights/roll_control_fail	float	боков управл	0
			
sim/custom/lights/ga_main_fail	float	отказ ГА осн	0
sim/custom/lights/ga_reserve_fail	float	отказ ГА контр	0
sim/custom/lights/msg_lamp	float	MSG	0
sim/custom/lights/wpt_lamp	float	WPT	0
sim/custom/lights/stuard_call	float	вызов БП	0
sim/custom/lights/mgv_control_fail	float	отказ МГВ контр	0
sim/custom/lights/sns_lamp	float	СНС	0
sim/custom/lights/correct_on	float	коррекция включ	0
sim/custom/lights/change_ch_o	float	смена ЧО	0
sim/custom/lights/warning_terrain	float	внимание земля	0
sim/custom/lights/gs_low	float	глиссада низко	0
sim/custom/lights/cockpit_p_low	float	Р каб мало	0
sim/custom/lights/nvu_fail	float	отаказ НВУ	0
sim/custom/lights/nvu_vor_automat	float	НВУ-VOR автомат	0
sim/custom/lights/dist_autonom	float	дист автоном	0
sim/custom/lights/diss_memory	float	память ДИСС	0
sim/custom/lights/azimuth_autonom	float	азимут автоном	0
sim/custom/lights/srpbz_fail	float	отказ СРПБЗ	0
sim/custom/lights/tcas_ident	float	лампа идентификации ТКАС	0
			
sim/custom/lights/other_hatches	float	лампа для незадействованных люков	0
sim/custom/lights/left_front_pax_door	float	левая передняя дверь открыта	0
sim/custom/lights/left_mid_pax_door	float	левая средняя дверь открыта	0
sim/custom/lights/right_mid_pax_door	float	средняя средняя дверь открыта	0
sim/custom/lights/cargo_front_door	float	передний багажный люк	0
sim/custom/lights/cargo_back_door	float	передний багажный люк	0
sim/custom/lights/turn63_lamp	float	разворот 63 	0
sim/custom/lights/nosewheel_turn_off	float	поворот не включен	0
sim/custom/lights/busters_off	float	лампа бустера	0
			
sim/custom/lights/water_level_1	float	уровень воды 1	0
sim/custom/lights/water_level_12	float	уровень воды 1/2	0
sim/custom/lights/water_level_14	float	уровень воды 1/4	0
sim/custom/lights/water_level_0	float	уровень воды 0	0
sim/custom/lights/ra56_roll_fail_1	float	отказ РА56 крен	0
sim/custom/lights/ra56_roll_fail_2	float	отказ РА56 крен	0
sim/custom/lights/ra56_roll_fail_3	float	отказ РА56 крен	0
sim/custom/lights/ra56_pitch_fail_1	float	отказ РА56 тангаж	0
sim/custom/lights/ra56_pitch_fail_2	float	отказ РА56 тангаж	0
sim/custom/lights/ra56_pitch_fail_3	float	отказ РА56 тангаж	0
sim/custom/lights/ra56_course_fail_1	float	отказ РА56 курс	0
sim/custom/lights/ra56_course_fail_2	float	отказ РА56 курс	0
sim/custom/lights/ra56_course_fail_3	float	отказ РА56 курс	0
sim/custom/lights/nvu_no_reserve	float	резерва НВУ нет	0
sim/custom/lights/absu_work	float	испр АБСУ	0
			
sim/custom/lights/fire/smoke_1	float	дым в отсеках	0
sim/custom/lights/fire/smoke_2	float	дым в отсеках	0
sim/custom/lights/fire/smoke_zone2_left	float	дым в отсеках	0
sim/custom/lights/fire/smoke_zone2_right	float	дым в отсеках	0
sim/custom/lights/fire/smoke_zone3	float	дым в отсеках	0
sim/custom/lights/fire/smoke_zone4	float	дым в отсеках	0
sim/custom/lights/fire/smoke_zone5_left	float	дым в отсеках	0
sim/custom/lights/fire/smoke_zone5_right	float	дым в отсеках	0
sim/custom/lights/fire/smoke_zone6	float	дым в отсеках	0
sim/custom/lights/fire/fire_eng_1	float	пожар в двигателе	0
sim/custom/lights/fire/fire_eng_2	float	пожар в двигателе	0
sim/custom/lights/fire/fire_eng_3	float	пожар в двигателе	0
sim/custom/lights/fire/overheat_eng_1	float	перегрев двигателя	0
sim/custom/lights/fire/overheat_eng_2	float	перегрев двигателя	0
sim/custom/lights/fire/overheat_eng_3	float	перегрев двигателя	0
sim/custom/lights/fire/fuel_off_eng_1	float	топливо закрыто	0
sim/custom/lights/fire/fuel_off_eng_2	float	топливо закрыто	0
sim/custom/lights/fire/fuel_off_eng_3	float	топливо закрыто	0
sim/custom/lights/fire/check_overheat	float	проверь перегрев и дым	0
sim/custom/lights/fire/fire_apu	float	пожар ВСУ	0
sim/custom/lights/fire/turn_on_spz	float	включи СПЗ	0
			
sim/custom/lights/apu/low_oil	float	масла мало	0
sim/custom/lights/apu/low_oil_press	float	Р масла	0
sim/custom/lights/apu/high_temp	float	предельная температура	0
sim/custom/lights/apu/high_rpm	float	предельные обороты	0
sim/custom/lights/apu/pta6_fail	float	ПТА 6А неисправн	0
sim/custom/lights/apu/doors_open	float	створки открыты	0
sim/custom/lights/apu/fuel_press	float	Р топлива	0
sim/custom/lights/apu/start_ready	float	Готов к запуску	0
sim/custom/lights/apu/work_mode	float	Выход на режим	0
sim/custom/lights/apu/start_apu	float	запусти ВСУ	0
			
sim/custom/lights/engines/eng1_dangerous_vibro	float	опасная вибрация	0
sim/custom/lights/engines/eng1_oil_level	float	уровень масла	0
sim/custom/lights/engines/eng1_oil_p	float	давление масла	0
sim/custom/lights/engines/eng1_bypass_valve	float	клапаны перепуска	0
sim/custom/lights/engines/eng1_vna33	float	ВНА 33	0
sim/custom/lights/engines/eng1_reverse_lock	float	замок реверса	0
sim/custom/lights/engines/eng1_high_vibro	float	вибрация велика	0
sim/custom/lights/engines/eng1_chips	float	стружка в масле	0
sim/custom/lights/engines/eng1_fuel_p	float	давление топлива	0
sim/custom/lights/engines/eng1_filter_fail	float	фильтр засорен	0
sim/custom/lights/engines/eng1_vna0	float	ВНА 0	0
sim/custom/lights/engines/eng1_reverse_doors	float	створки реверса	0
			
sim/custom/lights/engines/eng2_dangerous_vibro	float	опасная вибрация	0
sim/custom/lights/engines/eng2_oil_level	float	уровень масла	0
sim/custom/lights/engines/eng2_oil_p	float	давление масла	0
sim/custom/lights/engines/eng2_bypass_valve	float	клапаны перепуска	0
sim/custom/lights/engines/eng2_vna33	float	ВНА 33	0
sim/custom/lights/engines/eng_at_on	float	АТ включен	0
sim/custom/lights/engines/eng2_high_vibro	float	вибрация велика	0
sim/custom/lights/engines/eng2_chips	float	стружка в масле	0
sim/custom/lights/engines/eng2_fuel_p	float	давление топлива	0
sim/custom/lights/engines/eng2_filter_fail	float	фильтр засорен	0
sim/custom/lights/engines/eng2_vna0	float	ВНА 0	0
sim/custom/lights/engines/eng_block	float	расстоп сектора	0
			
sim/custom/lights/engines/eng3_dangerous_vibro	float	опасная вибрация	0
sim/custom/lights/engines/eng3_oil_level	float	уровень масла	0
sim/custom/lights/engines/eng3_oil_p	float	давление масла	0
sim/custom/lights/engines/eng3_bypass_valve	float	клапаны перепуска	0
sim/custom/lights/engines/eng3_vna33	float	ВНА 33	0
sim/custom/lights/engines/eng3_reverse_lock	float	замок реверса	0
sim/custom/lights/engines/eng3_high_vibro	float	вибрация велика	0
sim/custom/lights/engines/eng3_chips	float	стружка в масле	0
sim/custom/lights/engines/eng3_fuel_p	float	давление топлива	0
sim/custom/lights/engines/eng3_filter_fail	float	фильтр засорен	0
sim/custom/lights/engines/eng3_vna0	float	ВНА 0	0
sim/custom/lights/engines/eng3_reverse_doors	float	створки реверса	0
			
sim/custom/lights/small/transponder1_fail	float	левая панель. отказ передатчика	0
sim/custom/lights/small/transponder1_kd	float	левая панель. КД	0
sim/custom/lights/small/transponder1_kp	float	левая панель. КП	0
sim/custom/lights/small/leftside_yellow	float	желтая лампа слева	0
sim/custom/lights/small/turn_on_aux	float	включи запасной	0
sim/custom/lights/small/front_hydr_fail_1	float	низкое давление ГС 1. передняя панель	0
sim/custom/lights/small/front_hydr_fail_2	float	низкое давление ГС 2. передняя панель	0
sim/custom/lights/small/front_hydr_fail_3	float	низкое давление ГС 3. передняя панель	0
sim/custom/lights/small/front_hydr_fail_4	float	низкое давление ГС аварийн. передняя панель	0
sim/custom/lights/small/rv5_left_dh	float	ВПР на левом РВ5	0
sim/custom/lights/small/rv5_right_dh	float	ВПР на правом РВ5	0
sim/custom/lights/small/vd15_lamp	float	лампа возле высотомера на передней панели	0
			
sim/custom/lights/small/bkk_ok	float	лампа исправности БКК на верхней панели	0
sim/custom/lights/small/heat_ok_1	float	лампа исправности обогрева	0
sim/custom/lights/small/heat_ok_2	float	лампа исправности обогрева	0
sim/custom/lights/small/heat_ok_3	float	лампа исправности обогрева	0
sim/custom/lights/small/sp50_c1	float	панель СП50 - курс 1	0
sim/custom/lights/small/sp50_g1	float	панель СП50 - глисс 1	0
sim/custom/lights/small/sp50_c2	float	панель СП50 - курс 2	0
sim/custom/lights/small/sp50_g2	float	панель СП50 - глисс 2	0
sim/custom/lights/small/transponder_red	float	красная лампа на ответчике	0
sim/custom/lights/small/transponder_green	float	зеленая лампа на ответчике	0
sim/custom/lights/small/tks_main_fail	float	отказ осн ГА на ТКС	0
sim/custom/lights/small/tks_contr_fail	float	отказ контр ГА на ТКС	0
			
sim/custom/lights/small/rls_ready	float	РЛС готов	0
sim/custom/lights/small/rls_weather	float	РЛС метео	0
sim/custom/lights/small/stu_roll	float	СТУ бок	0
sim/custom/lights/small/stu_pitch	float	СТУ прод	0
sim/custom/lights/small/stu_toga	float	УХОД	0
sim/custom/lights/small/at_2	float	AT 2	0
sim/custom/lights/small/at_1	float	AT 1	0
sim/custom/lights/small/nvu_on	float	НВУ испр	0
sim/custom/lights/small/nvu_corr	float	НВУ КОРР	0
sim/custom/lights/small/nav_1_to	float	NAV 1 НА	0
sim/custom/lights/small/nav_1_from	float	NAV 1 ОТ	0
sim/custom/lights/small/nav_2_to	float	NAV 2 НА	0
sim/custom/lights/small/nav_2_from	float	NAV 2 ОТ	0
			
sim/custom/lights/small/apu_gen_on	float	РАП подключен	0
sim/custom/lights/small/bus_npk_1	float	сети НПК лев на 3	0
sim/custom/lights/small/bus_npk_2	float	сети НПК прав на 1	0
sim/custom/lights/small/emerg_inv_115	float	аварийный преобразов. 115в	0
sim/custom/lights/small/gen_fail_1	float	генератор не работает	0
sim/custom/lights/small/gen_fail_2	float	генератор не работает	0
sim/custom/lights/small/gen_fail_3	float	генератор не работает	0
sim/custom/lights/small/bus_connected	float	сети соединены	0
sim/custom/lights/small/left_bus_use_bat	float	левая сеть от батарей	0
sim/custom/lights/small/right_bus_use_bat	float	правая сеть от батарей	0
sim/custom/lights/small/turn_off_bat_1	float	выключи батарею	0
sim/custom/lights/small/turn_off_bat_3	float	выключи батарею	0
sim/custom/lights/small/turn_off_bat_2	float	выключи батарею	0
sim/custom/lights/small/turn_off_bat_4	float	выключи батарею	0
sim/custom/lights/small/vu_on_1	float	ВУ1	0
sim/custom/lights/small/vu_on_2	float	ВУ1	0
sim/custom/lights/small/left_bus_on_tr2	float	левая сеть на тр 2	0
sim/custom/lights/small/right_bus_on_tr1	float	правая сеть на тр 1	0
sim/custom/lights/small/pts250_n1	float	ПТС 250 не работает	0
sim/custom/lights/small/pts250_n2	float	ПТС 250 на сеть 	0
			
sim/custom/lights/small/throttle_1_fire	float	лампа пожара на РУД	0
sim/custom/lights/small/throttle_2_fire	float	лампа пожара на РУД	0
sim/custom/lights/small/throttle_3_fire	float	лампа пожара на РУД	0
			
sim/custom/lights/small/oil_meter_1	float	зеленая масла на уровнях масла	0
sim/custom/lights/small/oil_meter_2	float	зеленая масла на уровнях масла	0
sim/custom/lights/small/oil_meter_3	float	зеленая масла на уровнях масла	0
			
sim/custom/lights/small/starter_high_rpm_1	float	опасные обороты стартера	0
sim/custom/lights/small/starter_high_rpm_2	float	опасные обороты стартера	0
sim/custom/lights/small/starter_high_rpm_3	float	опасные обороты стартера	0
sim/custom/lights/small/fuel_2500	float	остаток топлива 2500	0
sim/custom/lights/small/fuel_tank1_used	float	расход из бака 1	0
sim/custom/lights/small/fuel_tank3_left_fail	float	красная лампа бака 3 лев	0
sim/custom/lights/small/fuel_tank2_left_fail	float	красная лампа бака 2 лев	0
sim/custom/lights/small/fuel_tank2_right_fail	float	красная лампа бака 2 прав	0
sim/custom/lights/small/fuel_tank3_right_fail	float	красная лампа бака 3 прав	0
sim/custom/lights/small/fuel_pump_left_5	float	насос бака 5 лев	0
sim/custom/lights/small/fuel_pump_left_6	float	насос бака 6 лев	0
sim/custom/lights/small/fuel_pump_left_7	float	насос бака 7 лев	0
sim/custom/lights/small/fuel_pump_left_8	float	насос бака 8 лев	0
sim/custom/lights/small/fuel_pump_left_9	float	насос бака 9 лев	0
sim/custom/lights/small/fuel_pump_right_5	float	насос бака 5 прав	0
sim/custom/lights/small/fuel_pump_right_6	float	насос бака 6 прав	0
sim/custom/lights/small/fuel_pump_right_7	float	насос бака 7 прав	0
sim/custom/lights/small/fuel_pump_right_8	float	насос бака 8 прав	0
sim/custom/lights/small/fuel_pump_right_9	float	насос бака 9 прав	0
sim/custom/lights/small/fuel_pump_10	float	насос бака 10	0
sim/custom/lights/small/fuel_pump_11	float	насос бака 11	0
sim/custom/lights/small/fuel_pump_1	float	насос бака 1	0
sim/custom/lights/small/fuel_pump_2	float	насос бака 2	0
sim/custom/lights/small/fuel_pump_3	float	насос бака 3	0
sim/custom/lights/small/fuel_pump_4	float	насос бака 4	0
			
sim/custom/lights/small/fuel_cut_off_1	float	перекрывные краны	0
sim/custom/lights/small/fuel_cut_off_2	float	перекрывные краны	0
sim/custom/lights/small/fuel_cut_off_3	float	перекрывные краны	0
sim/custom/lights/small/fuel_flow_from_2	float	порядок расхода	0
sim/custom/lights/small/fuel_flow_from_3	float	порядок расхода	0
sim/custom/lights/small/fuel_flow_from_4	float	порядок расхода	0
sim/custom/lights/small/fuel_flow_auto_fail	float	автомат расхода не работает	0
sim/custom/lights/small/fuel_reserv_trans_left	float	резервная перекачка в бак 1 	0
sim/custom/lights/small/fuel_reserv_trans_right	float	резервная перекачка в бак 1 	0
sim/custom/lights/small/fuel_porc_reserv	float	порцевание	0
sim/custom/lights/small/fuel_level_automat	float	автомат выравнивания	0
sim/custom/lights/small/skv_overheat	float	перегрев СКВ	0
sim/custom/lights/small/skv_overpress_left	float	превышение давления	0
sim/custom/lights/small/skv_overpress_right	float	превышение давления	0
sim/custom/lights/small/skv_tail_temp	float	температура хв отсека велика	0
sim/custom/lights/small/skv_bleed_fail_1	float	отказ отбора	0
sim/custom/lights/small/skv_bleed_fail_2	float	отказ отбора	0
sim/custom/lights/small/skv_bleed_fail_3	float	отказ отбора	0
sim/custom/lights/small/skv_bleed_closed_1	float	отбор закрыт	0
sim/custom/lights/small/skv_bleed_closed_2	float	отбор закрыт	0
sim/custom/lights/small/skv_bleed_closed_3	float	отбор закрыт	0
sim/custom/lights/small/apd_work_1	float	АПД работает	0
sim/custom/lights/small/apd_work_2	float	АПД работает	0
sim/custom/lights/small/apd_work_3	float	АПД работает	0
			
sim/custom/lights/small/eng_hydr_fail_1	float	низкое давление ГС 1.панель БИ	0
sim/custom/lights/small/eng_hydr_fail_2	float	низкое давление ГС 2. панель БИ	0
sim/custom/lights/small/eng_hydr_fail_3	float	низкое давление ГС 3. панель БИ	0
sim/custom/lights/small/eng_hydr_fail_4	float	низкое давление ГС аварийн. панель БИ	0
			
sim/custom/lights/small/tail_temp_high	float	тем. хв. отсека велика	0
sim/custom/lights/small/lavatory_heat	float	обогрев слива туалета	0
sim/custom/lights/small/galley_heat	float	обогрев слива кухни	0
sim/custom/lights/small/msrp_mlp_main	float	МСРП. МЛП ОСН	0
sim/custom/lights/small/msrp_mlp_aux	float	МСРП. МЛП ДОП	0
sim/custom/lights/small/msrp_up2	float	МСРП. УП2	0
sim/custom/lights/small/msrp_mars	float	МСРП. МАРС	0
			
sim/custom/lights/small/srd_low_press	float	давление кабины мало	0
sim/custom/lights/small/srd_overpress	float	перенаддув кабины	0
sim/custom/lights/small/soi_work	float	СОИ исправен	0
sim/custom/lights/small/soi_ice_detected	float	СОИ обледенение	0
sim/custom/lights/small/antiice_slats	float	заслонки продивообледенителей	0
sim/custom/lights/small/antiice_eng_1	float	заслонки продивообледенителей	0
sim/custom/lights/small/antiice_eng_2	float	заслонки продивообледенителей	0
sim/custom/lights/small/antiice_eng_3	float	заслонки продивообледенителей	0
sim/custom/lights/small/antiice_wings	float	заслонки продивообледенителей	0
sim/custom/lights/small/close_toilet	float	закройте туалет	0
			
sim/custom/lights/small/pnp_sp_left	float	лампа СП на ПНП лев	0
sim/custom/lights/small/pnp_vor_left	float	лампа VOR на ПНП лев	0
sim/custom/lights/small/pnp_nv_left	float	лампа HB на ПНП лев	0
sim/custom/lights/small/pnp_rsbn_left	float	лампа РСБН на ПНП лев	0
sim/custom/lights/small/pnp_sp_right	float	лампа СП на ПНП прав	0
sim/custom/lights/small/pnp_vor_right	float	лампа VOR на ПНП прав	0
sim/custom/lights/small/pnp_nv_right	float	лампа HB на ПНП прав	0
sim/custom/lights/small/pnp_rsbn_right	float	лампа РСБН на ПНП прав	0
sim/custom/lights/small/dme_mile_left	float	лампа мили на ДМЕ лев	0
sim/custom/lights/small/dme_km_left	float	лампа км на ДМЕ лев	0
sim/custom/lights/small/dme_mile_right	float	лампа мили на ДМЕ прав	0
sim/custom/lights/small/dme_km_right	float	лампа км на ДМЕ прав	0
			
sim/custom/lights/button/absu_zk	float	АБСУ ЗК	0
sim/custom/lights/button/absu_reset	float	АБСУ сброс	0
sim/custom/lights/button/absu_nvu	float	АБСУ НВУ	0
sim/custom/lights/button/absu_az1	float	АБСУ АЗ1	0
sim/custom/lights/button/absu_az2	float	АБСУ АЗ2	0
sim/custom/lights/button/absu_app	float	АБСУ заход	0
sim/custom/lights/button/absu_gz	float	АБСУ глисс	0
sim/custom/lights/button/absu_stab_m	float	АБСУ стаб М	0
sim/custom/lights/button/absu_stab_v	float	АБСУ стаб V	0
sim/custom/lights/button/absu_stab_h	float	АБСУ стаб H	0
sim/custom/lights/button/absu_stab	float	АБСУ стаб H	0
sim/custom/lights/button/absu_stab_spd	float	АБСУ стаб скорости	0
sim/custom/lights/button/absu_thro1	float	АБСУ откл Г1	0
sim/custom/lights/button/absu_thro2	float	АБСУ откл Г2	0
sim/custom/lights/button/absu_thro3	float	АБСУ откл Г3	0
sim/custom/lights/button/dejur_contr	float	дежур контр	0
sim/custom/lights/button/sound_off	float	откл звук	0
			
sim/custom/lights/button/fire_eng_1	float	тушение пожара двиг 1	0
sim/custom/lights/button/fire_eng_2	float	тушение пожара двиг 2	0
sim/custom/lights/button/fire_eng_3	float	тушение пожара двиг 3	0
sim/custom/lights/button/fire_apu	float	тушение пожара ВСУ	0
sim/custom/lights/button/fire_ng	float	тушение пожара НГ	0
sim/custom/lights/button/fire_turn_3	float	тушение пожара очередь 3	0
sim/custom/lights/button/fire_turn_2	float	тушение пожара очередь 2	0
sim/custom/lights/button/fire_turn_1	float	тушение пожара очередь 1	0
			
sim/custom/lights/white_light_left	int	светимость левого белого огня на крыле	1
sim/custom/lights/white_light_right	int	светимость правого белого огня на крыле	1
sim/custom/lights/beacon_light_B	int	светимость красного маяка внизу	1
sim/custom/lights/beacon_light_T	int	светимость красного маяка вверху	1
			
sim/custom/lights/sard_panel_lit	float	светимость панели САРД	0

sim/custom/lights/nvu_1_active	float	светимость активной панели НВУ	0
sim/custom/lights/nvu_2_active	float	светимость активной панели НВУ	0

sim/custom/lights/oil_qty_work_1	float	светимость лампы на масломере	1
sim/custom/lights/oil_qty_work_2	float	светимость лампы на масломере	1
sim/custom/lights/oil_qty_work_3	float	светимость лампы на масломере	1

sim/custom/rotary/KLN90/3D_L_Angle	int	поворот левой ручки КЛН90	0
sim/custom/rotary/KLN90/3D_R_Angle	int	поворот правой ручки КЛН90	0
sim/custom/rotary/KLN90/power_knob	int	вытягивание ручки питания	0
sim/custom/rotary/KLN90/power_knob_angle	int	поворот ручки питания КЛН90	0
sim/custom/rotary/KLN90/scan_knob	int	вытягивание ручки scan	0

sim/custom/switchers/wiper_left	int	переключатель работы стеклоочистителя. -1 - медленно, 0 - выкл, +1 - быстро	0
sim/custom/switchers/wiper_right	int	переключатель работы стеклоочистителя. -1 - медленно, 0 - выкл, +1 - быстро	0

sim/custom/anim/wiper_angle_left	float	угол поворота стеклоочистителя от края. 0 - 62	0
sim/custom/anim/wiper_angle_right	float	угол поворота стеклоочистителя от края. 0 - 62	0

sim/custom/switchers/kln_knob_out	int	вытягивание ручки КЛН	0
sim/custom/switchers/kln_power_knob	int	вдавливание ручки питания КЛН	0

sim/custom/lights/landing_light_off	int	выключатель фар	0
sim/custom/lights/landing_light_off_cap	int	выключатель фар	0

sim/custom/lights/gns430_lit	float	светимость панели ГНС	1

sim/custom/rotary/GNS430/LB_angle	int	поворот левой большой ручки GN430	0
sim/custom/rotary/GNS430/LS_angle	int	поворот левой малой ручки GN430	0
sim/custom/rotary/GNS430/RB_angle	int	поворот правой большой ручки GN430	0
sim/custom/rotary/GNS430/RS_angle	int	поворот правой малой ручки GN430	0